ohthere sæd|secgan hit|his|he hlaford ælfred cyninge|cyning þæt|se he eall|eal norþmann norþ bude
He cweðan þæt|se he buan|beodan on|an þæm|se land|finna norþeweard wiþ þu|þa|se Westsæ
He sæd|secgan þiсgan|þicgan|þeon|þeah þæt|se þæt|se land|finna wesan|seon|nesan swiþe|swiþan|swiþ|swiðe lang norþ þonan
ac hit wesan|seon|is eal weste|westan butan on|an feawa|feaw stow styccemælum wician finn on|an huntaþ on|an wintra|winter & on|an sumer on|an fiscaþ be þære|se sæ
He sæd|secgan þæt|se he æt|etan sum cyrr willan fandian hu long|lange þæt|se land|finna norþrihte liсgan|licgan oþþe|oððe hwæðer ænig mann|man be norþan þæm|se westen|westan bude
Þa for|faran he norþrihte be þæm|se land|finna lætan|lettan him|hi|he eall|eal wegan|weg þæt|se weste|westan land|finna on|an þæt|ðæt|se steorbord & þu|þa|se widsæ on|an þæt|ðæt|se bæcbord þrie|þri dagas
Þa wesan|seon|beon he swa feor norþ swa þu|þa|se hwælhunta feor faraþ
Þa for|faran he þu|þa|se git|gietan|geotan norþrihte swa feor swa he magan on|an þæm|se oþrum|oþer|oðer þri dæg|dah|dag gesiglan
Þa bugan|beah|beag þæt|se land|finna þær eastrihte oþþe|oððe seon|seo|se sæ in on|an þæt|ðæt|se lond
he næs|ne ysse hwæðer butan he witan þæt|ðæt|se he þær bidan westanwind & hwon norþan|norþ & siglan|seglan þe|þa|ða|se east be land|finna swa swa he magan on|an feower dæg|dah|dag gesiglan
Þa sculan he þær bidan rihtnorþanwind for|faran þæm|se þæt|se land|finna bugan|beah|beag þær suþrihte oþþe|oððe seon|seo|se sæ in on|an þæt|ðæt|se land
he næs|ne ysse hwæþer
Þa siglan|seglan he þanan suþrihte be land|finna swa swa he magan on|an fif dæg|dah|dag gesiglan
Ða liсgan|licgan þær on|an micel ea up in on|an þæt|se land
Þa cyrran hi|heo up in on|an þe|þa|ða|se ea for|faran þæm|se hi|heo nesan|neh|ne durran forþ bi|be þære|se ea siglan|seglan for|faran unfriþ for|faran þæm|se þæt|ðæt|se land|finna wesan|seon|beon eall|eal gebuan|buan on|an oþer|oðer healf þære|se eas
Ne metan he ær nan gebuan|buan land|finna siððan he from|fram hit|his|he agen ham for
Ac him|hi|he wesan|seon|beon eall|eal wegan|weg weste|westan land|finna on|an þæt|se steorbord butan fiscere & fugelere & huntum
& þæt|se wesan|seon|beon eall|eal Finnas
& him|hi|he wesan|seon|beon wifcynn|hosp|flet|a widsæ on|an þæt|ðæt|se bæcbord
Þa beormas habban swiþe|swiþan|swiþ|swiðe wel gebuan hira|hi land
ac hi|heo nesan|neh|ne durran þæron cuman
Ac þær|se terfinn land|finna wesan|seon|beon eal weste|westan butan þær hunta gewician oþþe|oððe fiscere oþþe|oððe fugeleras
Fela spellian|spell|spel him|hi|he secgan þu|þa|se beormas æghwæðer ge of hira|hi agen land|finna ge of þæm|se land|finna þu|þe|se ymb hi|heo utan wæron
ac he næs|ne ystan|yst hwæt#2 se soþ wesan|seon|beon for|faran þæm|se he hit self nesan|neh|ne geseah
Þa finn him|hi|he þynсan|þyncan & þu|þa|se beormas sprecan neah on|an geþeode
Swiþost he for|faran þider toeacan se land|finna sceawunge for|faran þæm|se horshwæl for|faran þæm|se hi|heo habbað swiþe|swiþan|swiþ|swiðe æþelu|æþele|æþel|æðele ban on|an hira|hi toþum
þa teð hi|heo bringan|brengan sum þæm|se cyninge
& hira|hi hydan|hyd bið swiðe|swiðan god toh|to sciprapum
Se hwæl bið micel læssa þonne|se oðer hwalas
ne bið he lengra þonne seofon eln|ellen lang
Ac on|an hit|his|he agen land|finna wesan|seon|is se god hwælhuntað
þa beoð eahtian|eahta and feowertig eln|ellen lange
& þu|þa|se micel fiftig eln|ellen lange
Þara he sæd|secgan þæt|se he six sum|su ofslean sixtig on|an twegen dagum
He wesan|seon|beon swiðe spedig munan|mann|man on|an þæm|se æht þu|þe|se hira|hi|heore sped on|an beoð þæt|se wesan|seon|is on|an wildrum
He habban þu|þa|se git þe|þa|ða|se he se cyningc sœ̄сan|seсan|secan tam deore|deor unbeboht six hund
Þa deor hi|heo hatað hranas
þara wesan|seon|beon six stælhranas
ða beoð swiðe dyre mid finn for|faran þæm|se hi foð þu|þa|se wilde hran mid
He wesan|seon|beon mid þæm|se fyrst mann on|an þæm|se lande
n æfde he þiсgan|þicgan|þeon|þeah micel þonne twentig hríðer & twentig sceap & twentig swyna
& þæt|se lytel þæt|se he erian he erian mid horsan
Ac hyra|hyr|hira|hi ar wesan|seon|is micel on|an þæm|se gafol þu|þe|se þe|þa|ða|se finn him|hi|he gyldað
Þæt gafol bið on|an deore|deor fel & on|an fugela feðer & hwæl ban & on|an þæm|se sciprap þu|þe|se beoð of hwæl hydan|hyd wyrсean|wyrсan|wyrcan|gewyrсean|gewyrсan|gewyrcan & of seoles
Æghwilc gyldan be his gebyrdum
Se byrdesta sceall gyldan fiftyne mearþ fellan|fel & fif hran & on|an beran|bera felan|fel & tynan|tin amber feðer & beren|beran cyrtel oððe yteren & twegen sciprapas
ægþer su sixtig eln|ellen lang
oþer su of hwæl hydan|hyd wyrсean|wyrсan|wyrcan|gewyrсean|gewyrсan|gewyrcan oþer|oðer of sioles
He sæd|secgan þæt|ðæt|se norþmann land|finna wære|wær|wesan|seon|beon swyþ|swyðe|swiðe lang & swiðe smæl
Eal þæt|se hit|his|he munan|mann|man ahwæþer oððe ettan oððe erian mæg|magan þæt|se lið wiþ|wið þe|þa|ða|se sæ
& þæt|se wesan|seon|is þiсgan|þicgan|þeon|þeah on|an sum stow swiðe cludig
& licgað wilde mor wiþ|wið eastan|east & wiþ|wið uppon|uppan efenlang þæm|se byn lande
On þæm|se moru|more|mor eardiað Finnas
& þæt|se byn land|finna wesan|seon|is easteweard bradost & simble swa norþ swa smælre
Eastewerd hit mæg|magan bion sixtig mil brad oþþe|oððe hwene brædre & middeweard þritig oððe bradre
& norþeweard he cweðan þær hit smæl wære|wær|wesan|seon|beon þæt|se hit miht|meaht|magan beon|beo|bannan þri mil brad toh|to þæm|se more
& se mor siððan on|an sum stow swa brad swa munan|mann|man mæg|magan on|an twegen wucu|wicu oferferan & on|an sum stow swa brad swa munan|mann|man mæg|magan on|an six dæg|dah|dag oferferan
Ðonne wesan|seon|is toefnes þæm|se land|finna suþeweard on|an oðer healf se mor sweoland oþ þæt|se land|finna norðeweard
& toefnes þæm|se land|finna norþeweard Cwena land
Þa Cwenas hergian hwilum|hwil on|an þe|þa|ða|se norþmann ofer se mor
hwilum þu|þa|se norþmann on|an hy
& þær wesan|seon swiðe|swiðan micel mere fersc geond þu|þa|se moras
& berað þu|þa|se Cwenas hyra|hyr|hira|hi scypu ofer land|finna on|an þe|þa|ða|se meras
& þanan hergian on|an þe|þa|ða|se Norðmen
hy habbað swiðe lytel scypa & swiðe leohte
Ohthere sæd|secgan þæt|se se scir|defena hatan halgoland þu|þe|se he on|an bude
He cweðan þæt|se nan munan|mann|man nesan|neh|ne buan|beodan be norþan him
Þonne wesan|seon|is on|an port on|an suþeweard þæm|se land|finna se munan|mann|man hætan|hatan Sciringesheal
Þyder he cweðan þæt|se munan|mann|man nesan|neh|ne miht|meaht|magan geseglian on|an an monaþ gif munan|mann|man on|an niht|neaht wician & ælc dæge|dæg habban ambyr wind
& ealle|eall|eal þe|þa|ða|se hwil he sculan seglian be lande
& on|an þæt|se steorbord him|hi|he bið ærest|ær iraland & þonne|se þe|þa|ða|se igland þu|þe|se synd betweoh iraland & þes lande
Þone wesan|seon|is þes land|finna oþ|oð he cymð toh|to sciringesheal & eall|eal wegan|weg on|an þæt|se bæcbord Norðweg
Æfter þæm|se þu|þe|se romeburh getimbran wesan|seon|beon feower hund winter & twentigsix fon alexander toh|to mæcedonia romana æfter philippus hit|his|he fæder & hit|his|he ær þegenscip on|an se gecyþan|gecyðan þu|þa|se he ealle|eall|eal crece mid hit|his|he snytro on|an hit|his|he geweald geniedan|genedan ealle|eall|eal þu|þa|se þu|þe|se wiþ|wið he gewin upahofon
Þæt wearð ærest|ær from|fram perse þu|þa|se hi|heo sellan demostanas þæm|se philosoph licgan feoh wiþ|wið þæm|se þu|þe|se he gelæran ealle|eall|eal crece þæt|se hi|heo alexander wiðsocen
Athene buan|beodan gefeohtan|gefeoht Alexandre
ac he hi|heo sona forslean & geflyman þæt|se hi|heo siððan ungemetlic ege from|fram him|hi|he habban & thebane fæsten|fæstan abrecan & mid ealle|eall|eal toweorpan se ær wesan|seon|beon eall|eal crece heafodstol & siððan þæt|se folc eall|eal on|an ellþeodge him|hi|he wiþ|wið feoh gesealde
& ealle|eall|eal þu|þa|se oðer þeod þu|þe|se on|an creca wesan|seon|beon he toh|to gafolgilda gedon butan mæcedonie þu|þe|se him|hi|he ær toh|to gecirran & þanan wesan|seon|beon faran on|an nilirice & on|an thracia & hi|heo ealle|eall|eal toh|to him|hi|he gebigde
& siððan he gegaderian fird wiþ|wið Perse
& þu|þa|se hwil þu|þe|se he hi|heo gaderade he ofslean ealle|eall|eal hit|his|he mæg þu|þe|se he geræcan mehte
On hit|his|he feðehere wesan|seon|beon þritigtwegen þusend & se gehorsian fifta healf þusend & scip on|an hund|1000 & eahtatig
N at ic cweðan orosius hwæðer micel|mare|mara wundor wesan|seon|beon þu|þe|se þæt|se he swa mid lytel fultuman|fultum se micel dælan|dæl þes middangeard gegan|gan magan þu|þe|se þæt|se he mid swa lytel weorod swa micel anginnan dorste
On þæm|se ær gefeohtan|gefeoht þu|þe|se alexander gefeohtan|feссan wiþ|wið darius on|an perse darius habban six hund|1000 þusend folces
He weorþan þeah swiðe beswican for|faran alexander searewe þonne|se for|faran hit|his|he gefeohte
Þær wesan|seon|beon ungemetlic wæl|wel slean|geslean Persa
& alexander næs|ne æs na micel þonne|se hund|1000 twentig on|an þæm|se rædehere & nigon on|an þæm|se feðan
Þa afor|afaran alexander þanan on|an friga asia land & hira|hi|heore cantwara|burg abrecan & toweorpan þu|þe|se mann|man hætt|hætan|hatan Sardis
Þa sægan|seсgan|secgan him|hi|he mann|man þæt|se darius habban eft fird gegaderian|gaderian on|an Persum
Alexander him|hi|he þæt|se þu|þa|se ondrædan for|faran þære|se nearu|nearo stow þu|þe|se he þu|þa|se on|an wesan|seon|beon & hrædlice for|faran þæm|se ege þanan afor|afaran ofer tauras se beorgan|beorg & ungelifedlic micelne|micel wegan|weg on|an þæm|se dæge|dæg gefaran oþ|oð he cuman toh|to tharsus þære|se byrgan|burg on|an cilicia þæm|se londe
On þæm|se dæge|dæg he gemetan an ea se habban ungemetlice ceald wæter seon|seo|se wesan|seon|beon ciðnus haten
Þa onginnan he he baðian þæron swa swatigne
þa for|faran þæm|se cyle him|hi|he gescrincan ealle|eall|eal þu|þa|se æder þæt|se him|hi|he mann|man se lifes|lif nesan|neh|ne wende
Raðe æfter þæm|se cuman darius mid firde toh|to Alexandre
He habban þri hund þusend feþa & on|an hund|1000 þusend gehorsedra
Alexander wesan|seon|beon þu|þa|se him|hi|he swiðe|swiðan ondrædan for|faran þære|se micel menigu & for|faran þære|se lytel þu|þe|se he self habban þeah þu|þe|se he ær mid þære|se ilca darius micel|mare|mara ofercome
Þæt gefeohtan|gefeoht wesan|seon|beon gedon|gedo|don mid micel geornfulnes of þæm|se folc bæm
& þær wesan|seon|beon þu|þa|se cyning begen gewundod
Þær wesan|seon|beon perse tin þusend ofslean gehorsian & eahtatig þusend feþa & eahtatig þusend gefangenra
& þær wesan|seon|beon ungemetlic micel licgan feoh findan on|an þæm|se wicstowun
Þær wesan|seon|beon darius modor gefon|gefangian|fon & hit|his|he wif se wesan|seon|beon hit|his|he swiostor & hit|his|he twegen dohtor
Ða beodan darius healf hit|his|he romana alexander wiþ þæm|se wifmonnum
ah him|hi|he næs|ne olde alexander se getygþian
Darius þu|þa|se git|gietan|geotan þridda siþ gegaderian fird of perse & eacan|eac of oþrum|oþer|oðer land se fultuman|fultum þu|þe|se he him|hi|he toh|to aspanan magan & wiþ|wið alexander for
Þa hwil þu|þe|se darius fird gegaderian þu|þa|se hwil sendan alexander parmenio hit|his|he ladteow þæt|se he darius sciphere gefliemde
& he self for|faran in Sirium
& hi|heo him|hi|he ongeagn cuman & hit|his|he mid eaþmodnes anfengon
& he þeah naðylæs hira|hi|heore land|finna oferhergian & þæt|se folc sum|su þær sittan lætan|lettan sum|su þanan adrifan sum on|an elðiode him|hi|he wiþ|wið feoh gesealde
& tirus þu|þa|se eald cantwara|burg & þu|þa|se welig he besittan & siððan tobrecan & mid ealle|eall|eal toweorpan for|faran þon|se hi|heo him|hi|he lustlice anfon næs|ne oldan & siððan for|faran on|an cilicia & þæt|se folc toh|to him|hi|he geniedan|genedan & siððan on|an roðos þæt|se iglond & þæt|se folc toh|to him|hi|he geniedde
& æfter þæm|se he for|faran on|an egipte & hi|heo toh|to him|hi|he geniedan|genedan & þær hettan|het|hedan|hatan þu|þa|se cantwara|burg atimbran þu|þe|se mann|man siððan be him|hi|he hettan|het|hedan|hatan Alexandria
& siððan he for|faran toh|to þæm|se hearg þu|þe|se egipte secgan þæt|se he wære|wær|wesan|seon|beon amon hira|hi|heore godes|god se wesan|seon|beon iobes sunu hira|hi|heore oþer|oðer godes|god toh|to þon|se þæt|se he willan beladian hit|his|he modor nectanebus se dry þu|þe|se mann|man sæd|secgan þæt|se heo hi|heo wiþ|wið forlicgan & þæt|se he alexander fæder wære
Þa bebeodan alexander þæm|se hæðen bisceop þæt|se he becreopan on|an se amon anlicnes þu|þe|se inne on|an þæm|se hearg wesan|seon|beon ær þæm|se þu|þe|se he & þæt|se folc hi|heo þær gegaderian & sæd|secgan hu he him|hi|he on|an hit|his|he gewil beforan þæm|þam|se folc andwerdan sculan se he he ascade

HER onginneð seon|seo|se gerecednys be antiochus þæm|þam|se ungesælig cingce and be apollonius þæm|þam|se tiriscan
An antiochia se ceaster wesan|seon|beon sum|su cyningc antiochus gehaten
æfter se cyning naman|nama wesan|seon|beon seon|seo|se ceaster antiochia geciged
Þises cyning cwen wearð of lif witan|gewitan be se he habban an swiðe|swiðan wlitig dohter ungelifedlic fægernesse
Mid þi|se þu|þe|se heo becuman toh|to giftelic ieldo þu|þa|se gyrnan hyrian|hyre|hyran|hyr|hire|heo manig mære|mæran munan|mann|man micel mærþu beodende
Ða gelimpan hit sarlic gelimpe
þa þe|þa|ða|se se fæder þenсean|þenсan|þencan hwæt|hwa he hi|heo miht|meaht|magan healice forgifan þu|þa|se gefeallan hit|his|he ongeagn|agen|agan mod on|an hyrian|hyre|hyran|hyr|hire|heo lufu|lufe mid unriht gewilnung toh|to ðam|se swiðe|swiðan þæt|se he forgitan|forgietan þu|þa|se fæderlic arfæstnes and gewilnian hit|his|he agen dohtor him|hi|he toh|to gemæccan
And þu|þa|se gewilnung nawiht|nagan lange|lang nesan|neh|ne ylde
ac sum dæge|dæg on|an ærmorgen þu|þa|se he of slæpan|slæp awacan he abrecan into ðam|se bur þær heo inne liсgan|licgan and hettan|het|hedan|hatan hit|his|he hiredmann ealle|eall|eal him|hi|he aweg gan swilce he wiþ|wið hit|his|he dohtor sum digol specan sprecan wolde
Hwæt he þe|þa|ða|se on|an se manfull scyld abisgian and þu|þa|se ongeanwinnende fæmne mid micel strengðu earfoþlice|earfoðlice ofercuman|ofercom and þæt|se gefremian munan|mann|man gewilnian toh|to bediglianne
Ða gewearð hit þæt|se se mæden fostermodor into ðam|se bur gan|eadan and geseon hi|heo þær sittan on|an micel gedrefednes and hire|heo cweðan to
Hwig wesan|seon þu hlæfdige swa gedrefan modes
Þæt mæden|mecgan hyrian|hyre|hyran|hyr|hire|heo andswerode
Leofe fostermodor nu todæg forweorþan twegen æðele naman|nama on|an þes bure
Seo fostermodor cwæð
Hlæfdige be hwæt|hwa cweþan|cweðan þu þæt
Heo hyrian|hyre|hyran|hyr|hire|heo andwirdan|andwerdan and cwæð
ær ðam|se dæge|dæg min brydgifta ic wesan|seon|eoh mid manfull scyld besmiten
Ða cweðan seon|seo|se fostormodor
Hwa wesan|seon|beon æfre swa dyrstig mod þæt|se durran cyng dohtor gewemman ær ðam|se dæge|dæg hyrian|hyre|hyran|hyr|hire|heo brydgifta and him|hi|he nesan|neh|ne ondrædan se cyning irre
Ðæt mæden|mecgan cwæð
Arleasnes þu|þa|se scyld on|an me|ic gefremode
Seo fostermodor cwæð
Hwar wesan|seon|is se fæder
Soðlice on|an me|ic earm wesan|seon|is min fæder nama hreowlice forworden
and me|ic nu forðam deað þearle gelicað
Seo fostermodor soþlice|soðlice þu|þa|se þe|þa|ða|se heo gehyrdan|gehyran þæt|se þæt|se mæden|mecgan hire|heo deaðes girnde þe|þa|ða|se clypian heo hi|heo hire|heo toh|to mid liðere sprecan and bædan|biddan þæt|se heo fram se gewilnung hyrian|hyre|hyran|hyr|hire|heo mod gewænde and toh|to hire|heo fæder willan|willa gebugan þiсgan|þicgan|þeon|þeah þu|þe|ðe heo toh|to geneadian wære
On þes þing soþlice|soðlice þurhwunian se arleasesta cyngc antiochus and mid gehywian mod he silf|self ætywan hit|his|he ceastergewaru swilce he arfæst fæder wære|wær|wesan|seon|beon hit|his|he dohtor
And betweoh hit|his|he hiwcuþ mann he blissian on|an ðam|se þæt|se he hit|his|he agen dohtor wer wæs
And toh|to ðam|se þæt|se he þu|þe|se lange brucan miht|meaht|magan hit|his|he dohtor arleas brydbed and him|hi|he fram adrifan þu|þa|se þu|þe|ðe hyrian|hyre|hyran|hyr|hire|heo gyrnan toh|to riht gesinscipe he asettan þe|þa|ða|se rædels þus cweðende
Swa hwilc munan|mann|man swa min rædels rihtan|riht arædan onfon se mynre|min dohtor toh|to wife
and se þu|þe|ðe he misrædan su he beheafdod
Hwæt wesan|seon|is nu micel|mare|mara ymbe|ymb þæt|se toh|to sprecanne butan þæt|se cyning æghwanan coman and ealdorman for|faran ðam|se ungelifedlic wlite|wlitan se mædenes
and se deað hi|heo oferhogian and se rædels understondan|understandan toh|to arædenne
Ac gif hira|hi|heore hwilc þonne|se þurh asmeagung bocliс|boclic snotorness se rædels ariht rædan þonne|se wearð se toh|to beheafdung gelædan swa same swa se þu|þe|ðe he ariht nesan|neh|ne rædde
And þu|þa|se heafod ealle|eall|eal wurdon|weorþan gesette|gesettan on|an ufeweard þæm|þam|se geate
Mid þi|se soþlice|soðlice antiochus se wælreow|wælhreow cyningc on|an þes wælhreowness þurhwunian þe|þa|ða|se wesan|seon|beon apollonius hatan|gehatan sum|su iung munan|mann|man se wesan|seon|beon swiðe|swiðan welig and snotor and wesan|seon|beon ealdorman on|an tirus se mægþ se getruwian on|an hit|his|he snotorness and on|an þe|þa|ða|se boclic lar and aginnan|agan rowan oþ|oð þæt|se he becuman toh|to Antiochian
Eode þu|þa|se into ðam|se cyninge|cyning and cwæð
Wes gesund cyningc
Hwæt ic becuman nu toh|to þu|þe|ðe swa swa toh|to god fæder and arfæstum
Ic wesan|seon|eoh soþlice|soðlice of cynelic cynn cumen
and ic biddan þinne|þin dohtor me|ic toh|to gemæccan
Ða þe|þa|ða|se se cyngc þæt|se gehyrdan|gehyran þæt|se he hit|his|he willa gehyran næs|ne olde he swiðe|swiðan irlic andwlitan|andwlita beseon toh|to ðam|se iungan ealdorman and cwæð
þu iunga mann cunnan þu se don|dom min dohtor gifta
Apollonius cwæð
Ic сinan|cunnan se dom
and ic he æt|etan þæm|þam|se gietan|geatan|geat geseah
Ða cweðan se cyningc mid æbilignesse
Gehir nu se rædels
Scelere vereor materna carne vescor
þæt wesan|seon|is on|an englisc
Scylde ic þolige
moddrenum flæsc ic bruce
Eft he cwæð
Quaero patrem meum meae matris virum uxoris meae filiam nec invenio
þæt wesan|seon|is on|an englisc
Ic sec min fæder mynre|min modor wer min wif dohtor
and ic nesan|neh|ne finde
Apollonius þu|þa|se soþlice|soðlice onfangenum rædels he bewendan hwon fram ðam|se cyninge
and mid þywan|þy|þe|se þu|þe|se he smeagean|smeagan ymbe|ymb þæt|se ingehyd he hit gewan mid wisdome
and mid godes|god fultuman|fultum he þæt|se soð arædde
Bewænde he þu|þa|se toh|to ðam|se cynincge and cwæð
þu god cyningc þu asettan rædels
gehyr þu þu|þa|se onfundennesse
Ymbe þæt|se þu cweþan|cweðan þæt|se þu scyld þolian nesan|neh|ne wesan|seon þu leogan on|an ðam
beseoh toh|to þu|þe|ðe silfum
and þæt|se þu cweþan|cweðan modren flæsc ic brucan nesan|neh|ne wesan|seon þu on|an ðam|se leogende
beseoh toh|to þinne|þin dohtor
Mid þywan|þy|þe|se þu|þe|se se cyningc gehirde þæt|se apollonius se rædels swa rihte|rihtan|riht arædan þu|þa|se ondrædan he þæt|se hit toh|to widcuþ wære
Beseah þe|þa|ða|se mid irlic andwlitan|andwlita toh|to him|hi|he and cwæð
ðu iunga munan|mann|man þu wesan|seon feor fram rihte
þu dwelast
and næs|ne wesan|seon|is nawiht|nagan þæt|se þu segst
ac þu hæftan|habban beheafdung geearnad
Nu lætan|læt ic þu|þe|ðe toh|to þritig dæg|dah|dagian|dag fæc þæt|se þu beþencan se rædels ariht
and þu siððan onfon minre|min dohtor toh|to wife
and gif þu þæt|se nesan|neh|ne don þu sculan oncnawan se gesettan dom
Ða wearð apollonius swiðe|swiðan gedrefan|drefan and mid hit|his|he gefere|gefera|gefer on|an scip astigan and rowan oþ|oð þæt|se he becuman toh|to Tirum
Soðlice æfter þæm|þam|se þu|þe|se apollonius afaran wesan|seon|beon antiochus se cyningc him|hi|he toh|to gecigan hit|his|he dihtere se wesan|seon|beon thaliarcus gehaten
Thaliarce eall|eal min digolnessa min se getreowe þegn wite|witan þu þæt|se apollonius ariht arædan min rædels
Astih nu rædlice|hrædlice on|an scip and faran æfter him
and þonne|se þu him|hi|he toh|to becuman þonne|se acwellan|acwelan þu he mid isen oððe mid ator þæt|se þu maga freodom onfon þonne|se þu ongeagn cymst
Thaliarcus sona swa he þæt|se gehyrdan|gehyran he geniman mid him|hi|he ge feoh ge ator and on|an scip astigan and for|faran æfter þæm|þam|se unsceþþig apollonius oþ|oð þæt|ðæt|se he toh|to hit|his|he eðle becom
Ac apollonius þeahhwæðere ær becuman toh|to hit|his|he agen and into hit|his|he hus gan|eadan and hit|his|he boccest untynan and asmeagan se rædels æfter eall|eal uðwitena and chaldea wisdome
Mid þi|se þu|þe|se he nawiht|nagan elles nesan|neh|ne onfindan butan þæt|se he ær geþenсan|geþencan he cweðan þu|þa|se toh|to him|hi|he silfum
Hwæt don þu nu Apolloni
Ðæs cyng rædels þu asmeadest
and þu hit|his|he dohtor nesan|neh|ne onfenge
forðam þu wesan|seon nu fordeman þæt|se þu acwellan wurðe
And he þu|þa|se ut gan|eadan and hettan|het|hedan|hatan hit|his|he scip mid hwæte gehlæstan and mid micel gewiht gold and seolfor and mid manigfeald and genihtsum reaf and swa mid feawa|feaw þæm|þam|se getreowe mann on|an scip astigan on|an se þridda tidan|tid se niht|neaht and slean ut on|an þe|þa|ða|se sæ
Þa se æftera dæge|dæg wesan|seon|beon apollonius sœ̄сan|seсan|secan|geseсan and geacsod
ac he nesan|neh|ne wesan|seon|beon nahwar funden
Ðar wearð þe|þa|ða|se micel murcnung and ormæte wop swa þæt|se se heaf swegan geond ealle|eall|eal þu|þa|se ceastre
Soðlice swa micel lufu|lufe habban eal seon|seo|se ceasterwaru toh|to him|hi|he þæt|se hi|heo lange|lang tidan|tid gan|eadan ealle|eall|eal unscoren and sidfeax and hira|hi|heore waforlic plegan|plega forlætan and hira|hi|heore baðian belucon
Þa þe|þa|ða|se þes þingc þus gedon wesan|seon|beon on|an tirus þe|þa|ða|se becuman se foresecgan thaliarcus se wesan|seon|beon fram antiochus þæm|þam|se cynincge asendan toh|to ðam|se þæt|se he sculan apollonius acwellan
Þa he geseon þæt|se ealle|eall|eal þes þingc belucan wesan|seon|beon þu|þa|se cweðan he toh|to an cnapan
Swa þu gesund sy
sege me|ic for|faran hwilc intinga þes|þeoh|se ceaster wunian on|an swa micel heaf and wope
Him andswerode se cnapa and þus cwæð
Eala hu manfull munan|mann|man þu wesan|seon þu þu|þe|se witan þæt|se þu æfter axsast
Oððe hwæt#2 wesan|seon|is mannian|mann þu|þe|se næs|ne ytan þæt|se þes|þeoh|se ceasterwaru on|an heaf wunað forðam þu|þe|ðe apollonius se ealdorman færinga nahwar nesan|neh|ne ætywan siððan he ongeagn cuman fram antiochus þæm|þam|se cyninge
Ða þu|þa|se thaliarcus þæt|se gehyrdan|gehyran he mid micel gefea toh|to scip gewænde and mid gewiss|gewis segling binnon an dæge|dæg cuman toh|to antiochia and gan|eadan into þæm|þam|se cyng and cwæð
Hlaford cyngc glæd|gladian nu and blissian|bliss forðam þu|þe|se apollonius him|hi|he ondrædan þin rices mægen swa þæt|se he nesan|neh|ne durran nahwar gewunian
Ða cweðan se cyningc
Fleon he mæg
ac he ætfleon nesan|neh|ne mæg
He þu|þa|se antiochus se cyningc gesette|gesettan þes geban þus cweðende
Swa hwilc munan|mann|man swa me|ic apollonius lifian toh|to gebringan ic him|hi|he gifu|gifan fiftig pund goldes
and þæm|þam|se þu|þe|ðe me|ic hit|his|he heafod toh|to gebringan ic gifu|gifan him|hi|he hund pund goldes
Þa þe|þa|ða|se þes geban þus settan|gesettan wesan|seon|beon þu|þa|se wesan|seon|beon mid gitsung beswicene na þæt|se on|an hit|his|he findan acan|ac eacan|eac swilce hit|his|he frind and him|hi|he æfter foran and he geond ealle|eall|eal eorþ|eorðe sœ̄сan|seсan|secan ge on|an dunland ge on|an wuduland ge on|an digol stowum
ac he nesan|neh|ne wearð nahwar funden
Ða hettan|het|hedan|hatan se cyngc scip gegearcian and him|hi|he æfter faran
ac hit wesan|seon|beon lang ær ðam|se þu|þe|se þe|þa|ða|se scip gegearcian wæron
and apollonius becuman ær toh|to Tharsum
Ða sum dæge|dæg gan|eadan he be strande
Þa geseon he sum|su hit|his|he cuþ mannian|mann se wesan|seon|beon hellanicus nemnian|genemnan se þu|þe|se ærest|ær þider com
Þa gan|eadan he toh|to apollonius and cwæð
Wes gesund hlaford Apolloni
Ða forseon he apollonius ceorlisc mann greting æfter riсe mannian|mann gewunan
Hellanicus he eftsona gegretan and cwæð
Wes gesund Apolloni
and nesan|neh|ne forseon þu ceorlisc munan|mann|man þu|þe|se bið mid weorþfull þeaw gefrætwod
Ac gehyran nu fram me|ic þæt|se þu self næs|ne ast
Þe wesan|seon|is soþlice|soðlice micel þurfan|þearf þæt|se þu þu|þe|ðe warnian|warenian forðam þu|þe|se þu wesan|seon fordemed
Ða cweðan Apollonius
Hwa miht|meaht|magan me|ic fordeman minre|min agen þeon|þeodan|þeod ealdorman
Hellanicus cwæð
Antiochus se cyngc
Apollonius cwæð
For hwilc intinga hæfð he me|ic fordemed
Hellanicus sæde
Forðam þu|þe|se þu gyrnan þæt|se þu wære|wær|wesan|seon|beon þæt|se se fæder is
Apollonius cwæð
Micclum ic wesan|seon|eoh fordemed
Hellanicus sæde
Swa hwilc munan|mann|man swa þu|þe|ðe lifian toh|to him|hi|he bringð onfon se fiftig pund goldes
Se þu|þe|ðe him|hi|he bringan þu|þin heafod onfon se hundteontig|1000 pund goldes
Forðam ic þu|þe|ðe læran|lesan þæt|se þu fleon|fleo and beorgan|beorg þin life
Æfter þes word hellanicus fram him|hi|he gewænde
and apollonius hettan|het|hedan|hatan he eft toh|to him|hi|he geclipian and cweðan toh|to him
þæt wyrreste þingc þu didest þæt|se þu me|ic warnodest
Nym nu heran|her æt|etan me|ic hundteontig|1000 pund gold and faran toh|to antiochus þæm|þam|se cyng and secgan him|hi|he þæt|se me|ic su þæt|se heafod fram þæm|þam|se hnecca aceorfan and bringan þæt|se word þæm|þam|se cyng toh|to blisse
þonne hafian|habban þu med and eacan|eac clæne hand fram se unsceþþig blode
Ða cweðan Hellanicus
Ne gewurðe þæt|se hlaford þæt|se ic med niman æt|etan þu|þe|ðe for|faran þes þing forðam þu|þe|se mid god mann næs|ne wesan|seon|is nahwæðer nesan|neh|ne gold nesan|neh|ne seolfor wiþ|wið god mann freondscipe wiðmeten
Hi togan þu|þa|se mid þes wordum
And apollonius sona gemetan oðer cuþ munan|mann|man ongeagn he gan se nama wesan|seon|beon stranguilio gehaten
Hlaford geong|gangan apollonius hwæt#2 don þu þus gedrefan mod on|an þes lande
Apollonius cwæð
Ic gehirde secgan þæt|se ic wære|wær|wesan|seon|beon fordemed
Stranguilio cwæð
Hwa fordeman þe
Apollonius cwæð
Antiochus se cyngc
Stranguilio cwæð
For hwilc intingum
Apollonius sæde
Forðam þu|þe|se ic bædan|biddan hit|his|he dohtor me|ic toh|to gemæcca be se ic mæg|magan toh|to soð secgan þæt|se heo hit|his|he ongeagn|agen|agan gemæcca wære
Forðam gif hit gewurðan mæg|magan ic willan me|ic bediglian on|an eowrum eðle
Ða cweðan Stranguilio
Hlaford apollonius ure|ur ceaster wesan|seon|is þurfan|þearfan and nesan|neh|ne mæg|magan þin æþelborenness|æðelborenness|æðelborennes acuman forðam þu|þe|ðe we þoliað se heardestan hungor and se reðestan
and minre|min ceasterwaru næs|ne wesan|seon|is nan hælu hiht
ac se wælhreow deað standan ætforan ure|ur eagum
Ða cweðan Apollonius
Min se leofesta freond stranguilio þancian god þæt|se he me|ic flyma hider toh|to eowrum gemære gelædde
Ic sillan eowrum ceastergewara hundteontig|1000 þusend mitta hwætes|hwæte gif ge min fleam bedigliað
Mid þi|se þu|þe|se stranguilio þæt|se gehirde he he astreccan toh|to hit|his|he fot and cwæð
Hlaford apollonius gif þu þes hungrig ceasterwaru gehelpan na þæt|se on|an þæt|se we willað þinne|þin fleam bediglian acan|ac eacan|eac swilce gif þu|þe|se neod gebyrian we willað campian for|faran þin hælo
Ða astigan apollonius on|an þæt|se domsetl on|an se stræte|stræt and cweðan toh|to ðam|se andweard ceasterwarum
Ge tharsysc ceasterwara ic apollonius se tirisc ealdorman ge|eowan|eow cyþan þæt|se ic gelifan þæt|se ge willan|willa beon|beo|bannan gemindig þes fremfulnes and min fleam bediglian
Wite ge eacan|eac þæt|se antiochus se cyngc me|ic afliman hæfð of minum|min earde
ac for|faran eowre gesælþ gefultuman god ic wesan|seon|eoh hider cumen
Ic sillan ge|eowan|eow soþlice|soðlice hundteontig|1000 þusend mitta hwætes|hwæte toh|to ðam|se weorþ þu|þe|se ic hit gebycgan on|an minum|min lande
Ða þe|þa|ða|se þæt|se folc þæt|se gehirde hi|heo wesan|seon|beon bliðe gewordene and him|hi|he georne|geornan|georn þancian and toh|to geflit se hwæte up bæron
Hwæt þe|þa|ða|se apollonius forlætan hit|his|he se weorþfull cynedom and mangere naman|nama þær geniman micel þonne|se gifendes
and þæt|se weorþ þu|þe|se he mid þæm|þam|se hwæte geniman he agifan|agiefan sona agean toh|to se ceaster bote
Þæt folc wearð þe|þa|ða|se swa fagen hit|his|he cystigness and swa þancfull þæt|se hi|heo|heg wyrсean|wyrсan|wyrcan him|hi|he an anlicnes of are
And on|an se stræte|stræt standan and mid se swiðran hand se hwæte healdan and mid þæm|þam|se winstre|winestra fot|fedan þu|þa|se mitta træd
and þæron|þaron þus awriten
ðas gifu sellan seon|seo|se ceasterwaru on|an tharsus apollonius þæm|þam|se tiriscan|tirisc forðam þu|þe|se he þæt|se folc of hungor alesan and hira|hi|heore ceaster gestaðolode
Æfter þes hit gelimpan binnon feawa|feaw monað þæt|se stranguilio and dionisiade hit|his|he wif gelæran apollonius þæt|ðæt|se he feran on|an scip toh|to pentapolis se cirinisc byrig and cweþan|cweðan þæt|se he miht|meaht|magan þær bediglian beon|beo|bannan and þær wunian
And þæt|se folc he þu|þa|se mid unasecgendlic weorþmynd toh|to scip gelæddon
and apollonius hi|heo bædan|biddan ealle|eall|eal gretan and on|an scip astah
Mid þi|se þu|þe|se hi|heo|heg onginnan þu|þa|se rowan and hi|heo forðweard wesan|seon|beon on|an hira|hi|heore wegan|weg þu|þa|se wearð se sæ smyltness awendan færinga betweoh twegen tidum
and wearð micel hreohness aweccan swa þæt|se seon|seo|se sæ cnyssan þu|þa|se heofonlic tungol and þæt|se gewealcan|gewealc þær|se yða hweoðerian mid windum
Þartoeacan coman eastnorþerne windas
and se angrislic suðwesterne windan|wind him|hi|he ongeagn stod
and þæt|se scip eal tobærst
On þes egeslic hreohness apollonius gefere|gefera ealle|eall|eal forweorþan toh|to deaðe
and apollonius ana|an becuman mid sunde|sund toh|to pentapolis þæm|þam|se cirinisc land|finna and þær up gan|eadan on|an ðam|se strande
Þa standan he nacod|nacian on|an þæm|þam|se strand and behealdan þu|þa|se sæ and cwæð
Eala þu sæ neptune mannian|mann bereafigend and unsceaþig beswicend þu wesan|seon wælreow|wælhreow þonne|se antiochus se cyngc
For minum|min þing þu gehealdan þes wælhreowness þæt|se ic þurh þu|þe|ðe geweorþan wædla and þearfian|þearfa and þæt|se se wælhreow cyngc me|ic þywan|þy|þe|se eaþ fordon mihte
Hwider mæg|magan ic nu faran
Hwæs mæg|magan ic biddan
oððe hwæt|hwa gifð þæm|þam|se uncuþ lifes|lif fultum
Mid þi|se þu|þe|se he þes þingc wesan|seon|beon sprecende|sprecan toh|to him|hi|he self þu|þa|se færinga geseon he sum fiscere gan
To þæm|þam|se he beseon and þus sarlice cwæð
Gemiltsa me|ic þu eald man
sy þæt|se þu sy
gemildsa me|ic nacod forlidenum
N æs na of earmlic byrd geborenum
And se þu|þe|ðe þu gearu|gearo forwitan hwæt|hwa þu gemiltsian ic wesan|seon|eoh apollonius se tirisc ealdorman
Ða sona swa se fiscere geseon þæt|se se iunga munan|mann|man æt|etan hit|his|he fot liсgan|licgan he mid mildheortness|mildheortnes he up ahebban and lædan he mid him|hi|he toh|to hit|his|he hus and þe|þa|ða|se est him|hi|he beforan leсgan|lecgan þu|þe|se he him|hi|he toh|to beodan hæfde
Þa git|gietan he willan be hit|his|he miht|meaht|magan micel|mare|mara arfæstnes him|hi|he gecyðan
toslat þu|þa|se hit|his|he wæfels on|an twegen|twa and sellan apollonius se healf dælan|dæl þus cweðende
Nim þæt|se ic þu|þe|se toh|to sillenne habbe and gan into se ceastre
Wen wesan|seon|is þæt|se þu gemetan|gemet sum þu|þe|se þu|þe|se gemiltsige
Gif þu nesan|neh|ne findan nan þu|þe|se þu|þe|se gemiltsian willan wænd þonne|se hider ongean
and genihtsumian wit begen min litlan æhta
and faran þu|þe|ðe on|an fiscnoþ mid me
Þeahhwæðre ic mynegian þu|þe|se gif þu fultuman god becuman toh|to þin ær weorþmynd þæt|se þu nesan|neh|ne forgitan min þearfendlic gegirlan
Ða cweðan Apollonius
Gif ic þu|þe|se nesan|neh|ne geþencan þonne|se me|ic wel|betan|bet bið ic wisce þæt|se ic eft forlidennes gefaran and þinne|þin gelica eft nesan|neh|ne gemete
Æfter þes word he gan|eadan on|an se wegan|weg þu|þe|se him|hi|he tæсan|tæcan|geteon wesan|seon|beon oþ|oð þæt|ðæt|se he becuman toh|to se ceaster gietan|geatan|geat and þær in eode
Mid þi|se þu|þe|se he þenсean|þenсan|þencan hwæne he byddan miht|meaht|magan lifes|lif fultuman|fultum þu|þa|se geseon he an nacod cnapa geond þu|þa|se stræte|stræt yrnan se wesan|seon|beon mid elh|ele gesmyrian and mid scite|scitan begyrdan and bær|beran iungra mannian|mann plegan|plega on|an hand toh|to ðam|se bæþstede belimpende
And clypian micel stefn and cwæð
Gehyre ge ceasterwaran
gehyre ge ælþeodig friсgan|frig|fricgan and þeowan|þeow æðele and unæðele
se bæþstede wesan|seon|is open
Ða þe|þa|ða|se apollonius þæt|se gehirde he he unscrydan þæm|þam|se healf sciccels þu|þe|ðe he on|an habban and gan|eadan into ðam|se þweale
and mid þi|se þu|þe|se he behealdan hira|hi|heore an gehwylc on|an hira|hi|heore weorc he sœ̄сan|seсan|secan hit|his|he gelican
ac he nesan|neh|ne miht|meaht|magan he þær findan on|an ðam|se flocce
Ða færinga cuman arcestrates eall|eal se þeon|þeodan|þeod cyningc mid micel menigu hit|his|he mannian|mann and in gan|eadan on|an þæt|se bæð
Ða aginnan|agan se cyngc plegan|plega wiþ|wið hit|his|he gefere|gefera mid þoðere
and apollonius he gemengan swa swa god willan on|an se cyning plegan|plega and yrnan se þoþor gelæссan|gelæccan and mid swift rædness geslean ongeagn gesendan toh|to ðam|se plegan cynge
Eft he agean asænde
he rædlice|hrædlice slean swa he he næfre fealle|feallan nesan|neh|ne let
Se cyngc þe|þa|ða|se oncnawan se iungan snelness þæt|se he witan|wist þæt|se he næs|ne æfde hit|his|he gelica on|an þæm|þam|se plegan
þa cweðan he toh|to hit|his|he geferan
Gað ge|eowan|eow heonon
Þes cniht se þu|þe|se me|ic þingð wesan|seon|is min|ic gelica
Ða þe|þa|ða|se apollonius gehyrdan|gehyran þæt|se se cyning he herian he yrnan|irnan|iernan rædlice|hrædlice and genealæcan toh|to ðam|se cynge
and mid gelæred hand he swingan se top mid swa micel swiftness|swiftnes þæt|se se cyngc wesan|seon|beon þynсan|geþyncan swilce he of yldan|yld|ildan|ild toh|to geoguþ gewænd wære
and æfter þæm|þam|se on|an hit|his|he cynesetl he him|hi|he gecwemlice ðenode
And þu|þa|se þe|þa|ða|se he ut gan|eadan of ðam|se bæðe he he lædan be se hand and him|hi|he þu|þa|se siððan þanan gewænde se weg þu|þe|se he ær com
Ða cweðan se cyningc toh|to hit|his|he mann siððan apollonius aginnan|agan wæs
Ic swerige þurh þe|þa|ða|se gemæne hælu þæt|se ic me|ic næfre wel|betan|bet nesan|neh|ne baðian þonne|se ic dide todæg
n at ic þurh hwilc iunges mann þenunge
Ða beseon he he toh|to an hit|his|he mannian|mann and cwæð
Ga and gewitan hwæt#2 se iunga munan|mann|man su þu|þe|se me|ic todæg swa wel gehirsumode
Se munan|mann|man þe|þa|ða|se gan|eadan æfter Apollonio
Mid þi|se þu|þe|se he geseon þæt|se he wesan|seon|beon mid horig|horhig sciccels bewæfan þu|þa|se wænde he ongeagn toh|to ðam|se cyng and cwæð
Se iunga munan|mann|man þu|þe|se þu æfter axsodest wesan|seon|is forliþan|forliðan|forliden man
Ða cweðan se cyng
þurh hwæt#2 witan þu þæt
Se munan|mann|man him|hi|he andswerode and cwæð
þeah he hit self forswigian hit|his|he gegerela he geswutelað
Ða cweðan se cyngc
Ga rædlice|hrædlice and secgan him|hi|he þæt|se se cyngc bitan|biddan|bidan þu|þe|ðe þæt|se þu cuman|ancuman toh|to hit|his|he gereorde
Ða apollonius þæt|se gehyrdan|gehyran he þæm|þam|se gehyrsumian and gan|eadan forþ|forð mid þæm|þam|se mann oþ|oð þæt|se he becuman toh|to se cyng healle
Ða gan|eadan se munan|mann|man in beforan toh|to ðam|se cyng and cwæð
Se forliðan|forliden munan|mann|man wesan|seon|is cuman þu|þe|se þu æfter sændest
ac he nesan|neh|ne mæg|magan for|faran sceamu|scamu in gan butan scrude
Ða hettan|het|hedan|hatan se cyngc he sona gescrydan mid weorþfull scrud and hettan|het|hedan|hatan he in gan toh|to ðam|se gereorde
Ða gan|eadan apollonius in and gesittan þær him|hi|he tæсan|tæcan|geteon wesan|seon|beon ongeagn se cyngc
Ðar wearð þe|þa|ða|se seon|seo|se þenung in geboren
and æfter þæm|þam|se cynelic gebeorscipe
and apollonius nan ðingc nesan|neh|ne æt|etan þeah þu|þe|ðe ealle|eall|eal oðer mann etan and bliðe wæron
ac he behealdan þæt|se gold and þæt|se seolfor and þe|þa|ða|se deorwyrþe reofan|reaf and þu|þa|se beod and þu|þa|se cynelic þenunga
Ða þe|þa|ða|se he þes eal mid sarness|sarnes behealdan þe|þa|ða|se sæt|sittan sum|su eald and sum|su æfestig ealdorman be þæm|þam|se cynge
Mid þi|se þu|þe|se he geseon þæt|se apollonius swa sarlice sæt|sittan and ealle|eall|eal þingc behealdan and nan ðingc nesan|neh|ne æt|etan þe|þa|ða|se cweðan he toh|to ðam|se cynge
ðu god cyngc efne|efnan|efen þes munan|mann|man þu|þe|se þu swa wel wiþ|wið gedon he wesan|seon|is swiðe|swiðan æfestful for|faran þin gode
Ða cweðan se cyngc
þe misþingð
Soðlice þes iunga munan|mann|man nesan|neh|ne æfestian on|an nanum|nan ðingum þu|þe|ðe he heran|her gesihð
ac he cyðan þæt|se he hæfð fela forloren
Ða beseon arcestrates se cyngc bliðe andwlitan|andwlita toh|to apollonius and cwæð
ðu iunga munan|mann|man beon|beo bliðe mid we|us and gehyhtan on|an god þæt|se þu motan|mot self toh|to ðam|se god becuman
Mid þi|se þu|þe|ðe se cyning þes word cweðan þe|þa|ða|se færinga þær gan|eadan in se cyng iunge dohtor and cystan|cyst|cyssan hyrian|hyre|hyran|hyr|hire|heo fæder and þe|þa|ða|se ymbsittendan
Þa heo becuman toh|to apollonius þu|þa|se gewænde heo ongeagn toh|to hire|heo fæder and cwæð
ðu god cyningc and min|ic se leofesta fæder hwæt#2 wesan|seon|is þes iunga munan|mann|man þu|þe|se ongeagn þu|þe|ðe on|an swa wurðlicum setl sittan mid sarlic andwlitan
N at ic hwæt#2 he besorgað
Ða cweðan se cyningc
Leofe dohtor þes iunga munan|mann|man wesan|seon|is forliden
and he gecweman me|ic mannian|mann wel|betan on|an ðam|se plegan
forðam ic he gelaðian toh|to þes ure|ur gebeorscipe
N at ic hwæt#2 he wesan|seon|is nesan|neh|ne hwanan he is
ac gif þu willan witan|wita hwæt#2 he su axsa he forðam þu|þe|se gedafenian þæt|se þu wite
Ða gan|eadan þæt|se mæden|mecgan toh|to apollonius and mid forwandian sprecan cwæð
ðeah þu stille|stillan su and unrot þiсgan|þicgan|þeon|þeah ic þin æþelborenness|æðelborenness|æðelborennes on|an þu|þe|ðe geseo
Nu þonne|se gif þu|þe|ðe toh|to hefig nesan|neh|ne þince secgan me|ic þinne|þin naman|nama and þu|þin gelimp arecan me
Ða cweðan Apollonius
Gif þu for|faran neod axsast æfter minum|min naman|nama ic secg þe
ic he forleosan on|an sæ
Gif þu willan min æþelborenness|æðelborenness|æðelborennes witan|wita wite|witan þu þæt|se ic hi|heo|heg forlætan on|an Tharsum
Ðæt mæden|mecgan cwæð
Sege me|ic gewislice þæt|se ic hit mæge|mæg|magan understandan
Apollonius þu|þa|se soþlice|soðlice hyrian|hyre|hyran|hyr|hire|heo arecan ealle|eall|eal hit|his|he gelymp
and æt|etan se spræcan ende him|hi|he feollan|feallan tear of ðam|se eagum
Mid þywan|þy|þe|se þu|þe|se se cyngc þæt|se geseon he bewendan he þe|þa|ða|se toh|to se dohtor and cwæð
Leofe dohtor þu gesingodest
mid þywan|þy|þe|se þu|þe|se þu willan witan|wita hit|his|he naman|nama and hit|his|he gelimpan|gelimp þu hafian|habban nu geedniwian hit|his|he eald sar
Ac ic biddan þu|þe|se þæt|se þu gifu|gifan him|hi|he swa hwæt#2 swa þu wille
Ða þe|þa|ða|se þæt|se mæden|mecgan gehirde þæt|se hire|heo wesan|seon|beon alyfan fram hire|heo fæder þæt|se heo ær hyrian|hyre|hyran|hyr|hire|heo self gedon|gedo|don willan þe|þa|ða|se cweðan heo toh|to Apollonio
Apolloni soþlice|soðlice þu wesan|seon ure
Forlæt þin murcnunge
and nu ic min fæder leaf habbe ic gedon þu|þe|ðe weligne
Apollonius hire|heo se þancode
and se cyngc blissian on|an hit|his|he dohtor welwilledness and hyrian|hyre|hyran|hyr|hire|heo toh|to cwæð
Leofe dohtor hatan|hat feccan þin hearpe and gecigan þu|þe|ðe toh|to þin frynd and afirsian fram þæm|þam|se iungan hit|his|he sarnesse
Ða gan|eadan heo ut and hettan|het|hedan|hatan feccan hire|heo hearpan
and sona swa heo hearpian onginnan heo mid winsumum sang gemengan se hearpe sweg
Ða onginnan ealle|eall|eal þu|þa|se mann hi|heo herian on|an hyrian|hyre|hyran|hyr|hire|heo swegcræft
and apollonius ana|an swigode
Ða cweðan se cyningc
Apolloni nu þu don yfele|yfel forðam þu|þe|se ealle|eall|eal mann heriað min dohtor on|an hyrian|hyre|hyran|hyr|hire|heo swegcræft and þu ana|an hi|heo swigende tælst
Apollonius cwæð
Eala þu god cyngc gif þu me|ic gelifan ic secg þæt|se ic ongitan þæt|se soþlice|soðlice þu|þin dohtor gefeallan on|an swegcræft acan|ac heo næs|ne æfð he na wel geleornod
Ac hatan|hat me|ic nu sillan þu|þa|se hearpan
þonne witan þu þæt|se þu nu git|gietan næs|ne ast
Arcestrates se cyning cwæð
Apolloni ic oncnawan soþlice|soðlice þæt|se þu wesan|seon on|an eall|eal þing wel gelæred
Ða hettan|het|hedan|hatan se cyng sillan apollonius þu|þa|se hearpan
Apollonius þu|þa|se ut gan|eadan and he scrydan and settan an cynehelm uppon|uppan hit|his|he heafod and niman þu|þa|se hearpe on|an hit|his|he hand and in gan|eadan and swa standan þæt|se se cyngc and ealle|eall|eal þu|þa|se ymbsittan wendan|wenan þæt|se he næs|ne ær apollonius acan|ac þæt|se he wære|wær|wesan|seon|beon apollines se hæðen God
Ða wearð stilnes|stillness and swige weorþan|geweorþan innon se healle
And apollonius hit|his|he hearpenægel genam
and he þu|þa|se hearpestreng mid cræftan|cræft astirian onginnan and se hearpe swegan|sweg mid winsumum sang gemægnde
And se cyngc self and ealle|eall|eal þu|þe|se þær andweard wesan|seon|beon micel stefn clypian and he heredon
Æfter þes forlætan apollonius þu|þa|se hearpe and plegian|plegan and fela fæger þingian|þing þær forþ|forð teon þu|þe|se þæm|þam|se folc ungecnawen wesan|seon|beon and ungewunelic
and hi eall|eal þearle lician ælc þær|se þingian|þing þu|þe|ðe he forþ|forð teah
Soðlice mid þywan|þy|þe|se þu|þe|se se cyng dohtor geseon þæt|se apollonius on|an eall|eal god cræft swa wel wesan|seon|beon teon|geteon þu|þa|se gefeallan hyrian|hyre|hyran|hyr|hire|heo mod on|an hit|his|he lufe
Ða æfter se gebeorscipe geendung cweðan þæt|se mæden|mecgan toh|to ðam|se cynge
Leofa fæder þu lifan me|ic litle ær þæt|se ic motan gifan apollonius swa hwæt#2 swa ic willan of þin goldhorde
Arcestrates se cyng cweðan toh|to hyre
Gif him|hi|he swa hwæt#2 swa þu wille
Heo þe|þa|ða|se swiðe|swiðan bliðe ut gan|eadan and cwæð
Lareow apollonius ic gifu|gifan þu|þe|se be min fæder leaf twegen|twa hund|1000 pund gold and feower hund|1000 pund gewiht seolfor and se micel dælan|dæl deorwyrþe reaf and twentig þeow manna
And heo þu|þa|se þus cweðan toh|to ðam|se þeow mannum
Berað þes þingc mid ge|eowan|eow þu|þe|se ic behatan apollonius minum|min lareow and lecgað innon bur beforan minum|min freondum
Þis wearð þu|þa|se þus gedon|gedo|don æfter se cwene|cwen hæse
and ealle|eall|eal þu|þa|se mann hire|heo gifu|gifan herian|heredon þu|þe|ðe hi|heo|heg gesawon
Ða soþlice|soðlice geendian þu|þe|se gebeorscipe
and þu|þa|se mann ealle|eall|eal arisan and gretan se cyngc and þe|þa|ða|se cwene|cwen and biddan hi|heo|heg gesund beon|beo|bannan and ham gewændon
Eac swilce apollonius cwæð
ðu god cyngc and earm gemiltsigend and þu cwen lar lufiend beon|beo|bannan ge gesunde
He beseon eacan|eac toh|to ðam|se þeow mann þu|þe|se þæt|se mæden|mecgan him|hi|he forgifan habban and hi cweðan to
Nimað þes þingan|þing mid ge|eowan|eow þu|þe|se me|ic seon|seo|se cwen forgeaf
and gan we sec ure|ur gesthus þæt|se we magan we|us gerestan
Ða adrædan þæt|se mæden|mecgan þæt|se heo næfre eft apollonius nesan|neh|ne geseon|gesawan swa raðe swa heo willan and gan|eadan þu|þa|se toh|to hire|heo fæder and cwæð
ðu god cyningc lican þu|þe|ðe wel þæt|se apollonius þu|þe|se þurh we|us todæg gegodian wesan|seon|is þus heonan fare
and cuman|cuma yfele|yfel mann and bereafian hine
Se cyngc cwæð
Wel þu cwæde
Hat him|hi|he findan hwær he he mæge|mæg|magan weorþlice gerestan
Ða dide þæt|se mæden|mecgan swa hyrian|hyre|hyran|hyr|hire|heo bebiddan|bebeodan wæs
and apollonius onfon se wunung þu|þe|ðe he tæсan|tæcan|geteon wesan|seon|beon and þær in gan|eadan god þancian þu|þe|ðe him|hi|he nesan|neh|ne forwyrnan cynelic wurðscipes and frofres
Ac þæt|se mæden|mecgan habban unstille niht|neaht mid se lufu|lufe onælan þær|se word and sang þu|þe|se heo gehyrdan|gehyran æt|etan Apollonige
and na lengan|leng|lange heo nesan|neh|ne gebidan þonne hit dæg wesan|seon|beon acan|ac gan|eadan sona swa hit sunnan|leoht wesan|seon|beon and gesittan beforan hire|heo fæder bedde
Ða cweðan se cyngc
Leofe dohtor for|faran hwy|hwi wesan|seon þu þus ærwacol
Ðæt mæden|mecgan cwæð
Me aweccan þu|þa|se gecneordnys þu|þe|se ic gyrstandæg gehyrde
Nu biddan ic þu|þe|ðe forðam þæt|se þu befæstan me|ic ure|ur cuman|cuma apollonius toh|to lare
Ða wearð se cyningc þearle geblissian|blissian and hettan|het|hedan|hatan feccan apollonius and him|hi|he toh|to cwæð
Min dohtor gyrnan þæt|se heo motan|mot leornian æt|etan þu|þe|ðe þe|þa|ða|se gesælig lar þu|þe|ðe þu canst
And gif þu willan þes þing gehyrsum beon|beo|bannan ic swerige þu|þe|ðe þurh min rices mægen þæt|se swa hwæt#2 swa þu on|an sæ forleosan ic þu|þe|ðe þæt|se on|an land|finna gestaðelige
Ða þe|þa|ða|se apollonius þæt|se gehyrdan|gehyran he onfengc þæm|þam|se mædenne toh|to lar and hire|heo tæсan|tæcan swa wel swa he self geleornode
Hyt gelimpan þe|þa|ða|se æfter þes binnon feawa|feaw tid þæt|se arcestrates se cyngc healdan apollonius hand on|an handa
and gan|eadan swa ut on|an se ceaster stræte
Þa æt|etan neah cuman þær gan ongeagn hi þri gelæred wer and æþelboren þu|þa|se lange|lang ær gyrnan se cyning dohtor
Hi þe|þa|ða|se ealle|eall|eal þri togædere an stefn gretan se cyngc
Ða smearcian se cyng and hi toh|to beseon and þus cwæð
Hwæt wesan|seon|is þæt|se þæt|se ge me|ic an stefn gretton
Ða andswerode hira|hi|heore on|an and cwæð
We biddan gefyrn þynne|þin dohtor
and þu we|us oftrædlice mid elcung geswænctest
Forðam we cuman hider todæg þus togædere
We syndon þin ceastergewaran of æðele gebyrde|gebyrd geborene
Nu biddan we þu|þe|se þæt|se þu geceosan þu|þe|se an of we|us þri hwilc þu willan þu|þe|se toh|to aðum habban
Ða cweðan se cyngc
N abbe ge na god tima aredodne
Min dohtor wesan|seon|is nu swiðe|swiðan bysig ymbe|ymb hyrian|hyre|hyran|hyr|hire|heo leornunga
ac þu|þe|se læs|lesan þu|þe|se ic ge|eowan|eow wifcynn|hosp|flet|a lengan|leng|lange slæccan|slæc awritan eowre naman|nama on|an gewritan|gewrit and hire|heo morgengife
þonne asendan ic þu|þa|se gewrit minre|min dohtor þæt|se heo self geceosan hwilc eower heo wille
Ða didon þe|þa|ða|se cniht swa
and se cyngc niman þe|þa|ða|se gewrit and geinseglian hi|heo mid hit|his|he ringe and sellan apollonius þus cweðende
Nim nu lareow apollonius swa hit þu|þe|se nesan|neh|ne mislician and bryng þin lærincgmædene
Ða niman apollonius þu|þa|se gewrit and gan|eadan toh|to se cynelic healle
Mid þæm|þam|se þu|þe|se þæt|se mæden|mecgan geseon apollonius þu|þa|se cweðan heo
Lareow hwy|hwi gæstan|gan þu ana
Apollonius cwæð
Hlæfdige næs|ne æs git|gietan yfel wif
nim þes|se gewrit þu|þe|ðe þu|þin fæder þu|þe|se sænde and ræd
Ðæt mæden|mecgan niman and rædan þær|se þri cniht naman
ac heo nesan|neh|ne findan na se naman|nama þæron|þaron þu|þe|se heo wolde
Ða heo þu|þa|se gewrit oferrædan habban þe|þa|ða|se beseon heo toh|to apollonius and cwæð
Lareow nesan|neh|ne ofþyncan hit þu|þe|ðe gif ic þus wer geceose
Apollonius cwæð
Na acan|ac ic blissian swiðe þæt|ðæt|se þu miht þurh|ðurh þe|þa|ða|se lar þu|þe|se þu æt|etan me|ic underfon þu|þe|se self on|an gewritan|gewrit gecyðan hwilc hira|hi|heore þu wille
Min willian|willa wesan|seon|is þæt|se þu þu|þe|ðe wer geceosan þær þu self wille
Þæt mæden|mecgan cwæð
Eala lareow gif þu me|ic lufian þu hit besorgodest
Æfter þes word heo mid mod anrædnes awritan oðer gewritan|gewrit and þæt|se geinseglian and sellan Apollonio
Apollonius hit þu|þa|se ut bær|beran on|an þe|þa|ða|se stræte|stræt and sellan þæm|þam|se cynge
Ðæt gewritan|gewrit wesan|seon|beon þus gewriten
þu god cyngc and min|ic se leofesta fæder nu þu|þin mildheortness|mildheortnes me|ic leaf sellan þæt|se ic self motan ceosan hwilc wer ic willan ic secg þu|þe|ðe toh|to soðan
þone forliðan|forliden munan|mann|man ic wille
And gif þu wundrian þæt|se swa sceamfæst fæmne swa unforwandigendlice þes|se word awritan þonne|se wite|witan þu þæt|se ic habban þurh weaxan|weax abeodan þu|þe|ðe nan sceamu|scamu nesan|neh|ne сinan|cunnan þæt|se ic self þu|þe|ðe for|faran sceamu|scamu secgan nesan|neh|ne mihte
Ða þe|þa|ða|se se cyningc habban þæt|se gewritan|gewrit oferrædan þu|þa|se næs|ne iste he hwilc forliðan|forliden heo nemde
Beseah þe|þa|ða|se toh|to ðam|se þri cniht and cwæð
Hwilc ge|eower wesan|seon|is forliden
Ða cweðan hira|hi|heore on|an se hatan Ardalius
Ic wesan|seon|eoh forliden
Se oðer him|hi|he andwirdan|andwerdan and cwæð
Swiga ðu
adl þu|þe|se forniman þæt|se þu nesan|neh|ne beon|beo hal nesan|neh|ne gesund
Mid me|ic þu boccræft leornodest
and þu næfre butan se ceaster gietan|geatan|geat fram me|ic nesan|neh|ne come
Hwar gefaran þu forlidennesse
Mid se þu|þe|se se cyngc nesan|neh|ne miht|meaht|magan findan hwilc hira|hi|heore forliþan|forliðan|forliden wære|wær|wesan|seon|beon he beseon toh|to apollonius and cwæð
Nim þu apollonius þes gewritan|gewrit and rædan|ræd hit
Eaðe mæg|magan gewurðan þæt|se þu wite|witan þæt|se ic næs|ne at þu þu|þe|ðe þær andweard wære
Ða niman apollonius þæt|se gewritan|gewrit and rædde
and sona swa he ongitan|ongietan þæt|se he lufian|gelufod|gelufian wesan|seon|beon fram ðam|se mæden hit|his|he andwlita eal areodode
Ða se cyngc þæt|se geseon þu|þa|se niman he apollonius hand and he hwon fram þæm|þam|se cniht gewænde and cwæð
Wast þu se forliðan|forliden man
Apollonius cwæð
ðu god cyning gif þu|þin willian|willa bið ic he wat
Ða geseon se cyngc þæt|se apollonius mid rose rudu|reodan wesan|seon|beon eal oferbræded
þa ongitan|ongietan he se cwyde and þus cweðan toh|to him
Blissa blissian|bliss apollonius for|faran ðam|se þu|þe|se min|ic dohtor gewilnian se þu|þe|ðe min|ic willian|willa is
Ne mæg|magan soþlice|soðlice on|an þyslic þingon nan þinc gewurðan butan godes|god willan
Arcestrates beseon toh|to ðam|se þri cniht and cwæð
Soð wesan|seon|is þæt|se ic ge|eowan|eow ær sæd|secgan þæt|se ge nesan|neh|ne cuman on|an gedafenlic tidan|tid mynre|min dohtor toh|to biddanne
ac þonne|se heo mæg|magan hi|heo fram hyrian|hyre|hyran|hyr|hire|heo lar geæmtian þonne|se sænde ic ge|eowan|eow word
Ða gewændon hi|heo ham mid þes andsware
And arcestrates se cyngc healdan for|faran se apollonius hand and he lædan ham mid him|hi|he na swilce he cuma wære|wær|wesan|seon|beon acan|ac swilce he hit|his|he aðum wære
Ða æt|etan neah forlætan se cyng apollonius hand and gan|eadan ana|an into ðam|se bur þær hit|his|he dohtor inne wesan|seon|beon and þus cwæð
Leofe dohtor hwæne hafian|habban þu þu|þe|ðe сeosan|geсeosan|gecoren|geceosan|ceosan toh|to gemæccan
Ðæt mæden|mecgan þu|þa|se feolan toh|to hyrian|hyre|hyran|hyr|hire|heo fæder fot and cwæð
ðu arfæst fæder gehyran þinne|þin dohtor willan
Ic lufian se forliðan|forliden munan|mann|man þu|þe|ðe wesan|seon|beon þurh ungelimp beswicen
ac þi|se læs|lesan þu|þe|se þu|þe|se tweonian se sprecan apollonius ic willan min lareow
and gif þu me|ic him|hi|he nesan|neh|ne sillan þu forlætan|forlædan þin dohtor
Se cyng þe|þa|ða|se soþlice|soðlice nesan|neh|ne miht|meaht|magan aræfnian hit|his|he dohtor tear acan|ac aræran hi|heo up and hire|heo toh|to cwæð
Leofe dohtor nesan|neh|ne ondrædan þu þu|þe|ðe ænig þinges
Þu hafian|habban сeosan|geсeosan|gecoren|geceosan|ceosan se wer þu|þe|se me|ic wel licað
Eode þe|þa|ða|se ut and beseon toh|to apollonius and cwæð
Lareow apollonius ic smeagean|smeagan minre|min dohtor mod willan
Ða arecan heo me|ic mid wop betweoh oðer sprecan þes þingc þus cweðende
þu geswerian apollonius gif he willan gehyrsumian minum|min willan|willa on|an lar þæt|se þu willan him|hi|he geinnian swa hwæt#2 swa seon|seo|se sæ him|hi|he ætbræd
Nu for|faran ðam|se þu|þe|se he gehyrsum wesan|seon|beon þinne|þin hæs and minum|min willan|willa ic for|faran æfter him

Her beorhtric cyning forþferan & worr aldormon
& ecgbryht fon toh|to west-seaxe rice
& þywan|þy|þe|se ilca dæge|dæg ridan|rad æþelmund ealdorman of hwiccas ofer æt|etan Cynemæres.forda
þa metan he weoxtan ealdorman mid Wilsætum
þær weorþan micel gefeoht
& þær begen ofslean|ofslagan þu|þa|se aldormen
& wilsætan niman sige
Her wesan|seon|beon hadian|gehadian beornmod bisceop toh|to Hrofesceastre
Her æþelheard arcebisceop forþferde
& wulfred wesan|seon|beon toh|to arcebisceop gehadod
& forþred abbad forþferde
Her wulfred arcebisceop pallium onfeng
Her cuþred cyning forþferan on|an cantware & ceolburg abbadisse & heabryht aldorman
Her carl cyning forþferde
& he ricsian feowertigfif wintra
& wulfred arcebisceop & wigbryht west-seaxe bisceop faran begen toh|to Rome
Her wulfred arcebisceop mid bletsung se papa leo hwerfan|hweorfan eft toh|to hit|his|he agen biscepdome
& þywan|þy|þe|se geare|gear gehergian ecgbryht cyning on|an west-wealas from|fram easteweard oþ westewearde
Her leo se æþelu|æþelian|æþele|æþel|æðele papa & se halig|halgian|halga|haleg forþferde
& æfter him|hi|he stephanus fon toh|to rice
Her stephanus papa forþferde
& æfter him|hi|he was paschalis toh|to papa gehadod
& þywan|þy|þe|se ilca geare|gear forbirnan|forbiernan|forbeornan angelcynn scolu
Her cenwulf mirce cyning forþferde
& ceolwulf fon toh|to rice
& eadbryht ealdorman forþferde
Her weorþan ceolwulf hit|his|he rices besciered
Her twegen ealdorman wurdon|weorþan ofslean|ofslagan burghelm & Muca
& seonoþ wesan|seon|beon æt|etan Clofeshoo
Her wesan|seon|beon walas gefeohtan|gefeoht & defenas æt|etan Gafulforda
& þywan|þy|þe|se ilca geare|gear gefeohtan|feссan ecgbryht cyning & beornwulf cyning on|an Ellen.dune
& ecgbryht sige|sigan|seon nam
& þær wesan|seon|beon micel wæl|wel geslægen
Þa sendan he æþelwulf hit|his|he sunu of þære|se fierd & ealhstan hit|his|he bisceop & wulfheard hit|his|he ealdorman toh|to cent micel werede
& hi|heo baldred se cyning norþ ofer temesemuþa|temese|temes adrifon
& cantware him|hi|he toh|to cyrran & suþrige & suþ-seaxe & east-seaxe þywan|þy|þe|se hi|heo from|fram hit|his|he mæg ær mid unriht anydan wærun
& þywan|þy|þe|se ilca geare|gear east-engle cyning & seon|seo|se þeodan|þeod geseсan|gesecan ecgbryht cyning him|hi|he toh|to friþ & toh|to mundbora for|faran mirce ege
& þywan|þy|þe|se geare|gear slean east-engle beornwulf mirce cyning
Her ludecan mirce cyning & hit|his|he fif ealdorman mann|man ofslean mid him
& wiglaf fon toh|to rice
Her mona aþystrian on|an midd winter mæsseniht
& þywan|þy|þe|se ilca geare|gear gegan ecgbryht cyning mirce romana & eal|alan|al þæt|se be suþan|suþ humbre wæs
& he wesan|seon|beon se eahtoða cyning se þu|þe|se Bretwalda wæs
Ærest ælle suþ-seaxe cyning se þus micel romana hæfde
se æftera wesan|seon|beon ceawlin west-seaxe cyning
se þridda wesan|seon|beon æþelbryht cantware cyning
se feorþa wesan|seon|beon rædwald east-engle cyning
fifta was eadwine norþan-hymbre cyning
siexta wesan|seon|beon oswald se æfter him|hi|he ricsode
seofoþa wesan|seon|beon oswio oswald broþur
eahtoþa wesan|seon|beon ecgbryht west-seaxe cyning
& se ecgbryht lædan fierd toh|to dor wiþ Norþanhymbre
& hi|heo him|hi|he þær eaþmedu buan|beodan & geþuærnesse
& hi|heo on|an þæm|þam|se tohwurfon
Her eft wiglaf onfon mirce rices
& æþelwald bisceop forþferde
& þywan|þy|þe|se ilca geare|gear lædan ecgbryht cyning fierd on|an Norþ.Walas
& he hi|heo toh|to eaþmod hyrsumness gedyde
Her wulfred arcebisceop forþferde
Her ceolnoþ wesan|seon|beon сeosan|geсeosan|gecoren|geceosan|ceosan toh|to bisceop & gehadod
& feologid abbad forþferde
Her ceolnoþ arcebisceop onfon pallium
Her hæþen|hæðen mann oferhergian Sceapige
Her gefeohtan|feссan ecgbryht cyning wiþ þritigfif sciphlæst æt|etan Carrum
& þær weorþan micel wæl|wel geslægen
& þu|þa|se deniscan agan wælstow gewald
& hereferþ & wigþen twegen bisceop forþferdon
& dudda & osmod twegen ealdorman forþferdon
Her cuom micel sciphere on|an West.Walas
& hi|heo toh|to an gecirran & wiþ ecgbryht west-seaxe cyning winnan wæron
Þa he þæt|se hyran|hierde|hierdan|hieran & mid fierd feran & him|hi|he wiþ feohtan|feccan æt|etan hengestdun & þær geflyman ge þu|þa|se walas ge þu|þa|se Deniscan
Her ecgbryht cyning forþferde
& he habban ær offa mirce cyning & beorhtric west-seaxe cyning afliman þri gear of angelcynn land|finna on|an francland ær he cyning wære
& þywan|þy|þe|se fultumian|fultuman beorhtric offa þywan|þy|þe|se he habban hit|his|he dohtor him|hi|he toh|to cuene
& se ecgbryht ricsian þritigseofon wintra|winter & seofon monaþ
& fon æþelwulf ecgbrehting toh|to west-seaxe rice
& he salde hit|his|he sunu æþelstan cantware romana & east-seaxe & suþrige & Suþ.Seaxna
Her wulfheard ealdorman gefeohtan|feссan æt|etan hamtun wiþ þritigþri sciphlæst & þær micel wæl|wel geslean & sige|sigan|seon nom
& þywan|þy|þe|se geare|gear forþferan Wulfheard
& þywan|þy|þe|se ilca geare|gear gefeohtan|feссan æþelhelm dux wiþ denisc herian|here|heran on|an port mid dornsætum|dornsæte & god hwil se herian|here|heran gefliemde
& þu|þa|se deniscan|denisc agan wælstow geweald & se ealdorman ofslogon
Her herebryht ealdorman wesan|seon|beon ofslean from|fram hæþen|hæðen monnum
& manig mid him|hi|he on|an Merscwarum
& þywan|þy|þe|se ilca geare|gear eft on|an lindesse & on|an east-engle & on|an cantware wurdon|weorþan manig mann ofslean|ofslagan from|fram þæm|þam|se herige
Her wesan|seon|beon micel wælsliht on|an lunden & on|an cwantawic & on|an Hrofesceastre
Her æþelwulf cyning gefeohtan|feссan æt|etan carrum wiþ þritigfif sciphlæsta
& þu|þa|se deniscan|denisc agan wælstow gewald
Her eanulf ealdorman gefeohtan|feссan mid Sumursætum
& ealchstan bisceop & osric ealdorman mid dornsætum|dornsæte gefeohtan æt|etan pedrida muþa wiþ denisc herian|here|heran & þær micel wæl|wel geslean & sige|sigan|seon namon
Her Ceorl ealdorman gefeohtan|feссan wiþ hæþen|hæðen mann mid defena æt|etan wicganbeorg & þær micel wæl|wel geslean & sige|sigan|seon namon
& þywan|þy|þe|se ilca geare|gear æþelstan cyning & ealchere dux micelne|micel herian|here|heran ofslean æt|etan sandwic on|an cent & nigon scip gefon & þu|þa|se oþer|oðer gefliemdon
& hæþen|hæðen mann ærest|ær ofer winter sæton
& þywan|þy|þe|se ilca geare|gear cuom feorþa healfhund scip on|an temesemuþa|temese|temes muþa & brecan cantwara & lundenburh & geflyman beorhtwulf mirce cyning mid hit|his|he fierd & faran þu|þa|se suþ ofer temesemuþa|temese|temes on|an Suþrige
& him|hi|he gefeohtan|feссan wiþ æþelwulf cyning & æþelbald hit|his|he sunu æt|etan aclea mid west-seaxe fierd & þær þæt|se micel wæl|wel geslean on|an hæþen|hæðen herian|here þu|þe|se we secgan hyran|hierdan|hieran oþ þes ondweardan dæg & þær sige|sigan|seon namon
Her bædan|biddan burgred mirce cyning & hit|his|he wiotan æþelwulf cyning þæt|se he him|hi|he gefultuman þæt|se him|hi|he norþ-walas gehiersumade
He þu|þa|se swa dydan|don & mid fierd for|faran ofer mirce on|an norþ-walas & hi|heo him|hi|he eal|all gehyrsum|gehiersum dydon
& þywan|þy|þe|se ilca geare|gear sendan æþelwulf cyning ælfred hit|his|he sunu toh|to Rome
Þa was domne leo papa on|an Rome
& he he toh|to cyninge|cyning gehalgian & he him|hi|he toh|to bisceop-sunu nam
Þa þywan|þy|þe|se ilca geare|gear ealchere mid cantware & huda mid suþrige gefeohtan on|an tenet wiþ hæþen|hæðen herian|here & ærest|ær sige|sigan|seon namon
& þær weorþan manig mann|man ofslean & adrincan on|an gehwæðer hond
Ond se ofer easter gifan|giefan|gefan|geaf æþelwulf cyning hit|his|he dohtor burgred cyninge|cyning of west-seaxe on|an Merce
Her hæþen|hæðen mann ærest|ær on|an sceapig ofer winter sætun
& þywan|þy|þe|se ilca geare|gear gebocian æþelwulf cyning teoða dælan|dæl hit|his|he land ofer eal|alan|al hit|his|he romana god toh|to lof & him|hi|he self toh|to ece hælu & þywan|þy|þe|se ilca geare|gear feran toh|to rom mid micel weorþness & þær was twelf monaþ wunian & þu|þa|se him|hi|he hamweard for
& him|hi|he þu|þa|se carl francan cyning hit|his|he dohtor gifan|giefan|gefan|geaf him|hi|he toh|to cuene
& æfter þæm|þam|se toh|to hit|his|he leode|leoda|leod cuom
& hi|heo se gefægen wærun
& ymb twegen gear se þu|þe|ðe he on|an francan cuman he gefor
& hit|his|he liс|lic liþan|liþ æt|etan Wintanceastre
& he ricsian nigonteoþa healf gear
Ond þu|þa|se fon æþelwulf sunu twegen toh|to romana æþelbald toh|to west-seaxe romana & æþelbryht toh|to cantware romana & toh|to east-seaxe romana & toh|to suþrige & toh|to suþ-seaxe rice
& þu|þa|se ricsian æþelbald fif gear
Her æþelbald cyng forþferde
& hit|his|he liс|lic liþan|liþ æt|etan Sciraburnan
& fon æþelbryht toh|to eal|all þæm|þam|se romana hit|his|he broþur
& he hit healdan on|an god geþwærnes & on|an micel sibsumnesse
& on|an hit|his|he dæge|dæg cuom micel sciphere up & abrecan Wintanceastre
& wiþ se herian|here|heran gefeohtan osric ealdorman mid hamtunscir & æþelwulf ealdorman mid bearrucscir & se herian|here|heran geflyman & wælstow geweald ahton
& se æþelbryht ricsian fif gear
& hit|his|he liс|lic liþan|liþ æt|etan Scireburnan
Her sæt|sittan hæþen|hæðen herian|here|heran on|an tenet & geniman friþ wiþ Cantwarum
& cantware him|hi|he feoh gehatan wiþ þæm|þam|se friþe
& under þæm|þam|se friþ & þæm|þam|se feohgehat se herian|here|heran he on|an niht|neaht up bestelan & oferhergian eal|all cent eastewearde
Her fon æþered æþelbryht broðor toh|to west-seaxe rice
& þywan|þy|þe|se ilca geare|gear cuom micel herian|here|heran on|an angelcynn land & wintersetl niman on|an east-engle & þær gehorsian wurdon
& hi|heo him|hi|he friþ wiþ namon
Her for|faran se herian|here|heran of east-engle ofer humbre muþa toh|to eoforwicceaster on|an Norþhymbre
& þær wesan|seon|beon micel ungeþwærness þære|se þeon|þeodan|þeod betweoh him|hi|he selfum
& hi|heo hæfdun hira|hi cyning aweorpan osbryht & ungecynde cyning underfon Ællan
& hi|heo læt|late on|an geare|gear toh|to þæm|þam|se gecirran þæt|se hi|heo wiþ se herian|here|heran winnan wærun
& hi|heo þiсgan|þicgan|þeon|þeah micel fierd gegaderian & se herian|here|heran sœ̄сan|seсan|secan æt|etan eoforwicceaster & on|an þu|þa|se ceaster bræcon
& hi|heo sum inne wurdon
& þær was ungemetlic wæl|wel slean|geslean Norþanhymbra
sume binnan sum butan
& þu|þa|se cyning begen ofslægene
& se laf wiþ se herian|here|heran friþ nam
& þywan|þy|þe|se ilca geare|gear gefaran ealchstan biscep
& he habban þæt|se bisecoprice fiftig wintra|winter æt|etan Scireburnan
& hit|his|he liс|lic liþan|liþ þær on|an tune
Her for|faran se ilca herian|here|heran innan mirce toh|to snotingaham & þær wintersetl namon
& burgred mirce cyning & hit|his|he wiotan biddan æþered west-seaxe cyning & ælfred hit|his|he broðor þæt|se hi|heo him|hi|he gefultuman þæt|se hi|heo wiþ se herian|here|heran gefuhton
& þu|þa|se feran hi|heo mid west-seaxe fierd innan mirce oþ snotingaham & se herian|here|heran þær metan on|an þæm|þam|se geweorce
& þær nan hefelic gefeohtan|gefeoht nesan|neh|ne wearþ
& mirce friþ niman wiþ se here
Her for|faran se herian|here|heran eft toh|to eoforwicceaster & þær sæt|sittan an gear
Her ridan|rad se herian|here|heran ofer mirce innan east-engle & wintersetl niman æt|etan Þeodforda
& þywan|þy|þe|se winter eadmund cyning him|hi|he wiþ feaht
& þu|þa|se deniscan|denisc sige|sigan|seon niman & se cyning ofslean & þæt|se land eal|all geeodon
& þywan|þy|þe|se geare|gear gefaran ceolnoþ ærcebiscop
& æþered wiltunscir bisceop weorþan сeosan|geсeosan|gecoren|geceosan|ceosan toh|to arcebisceop toh|to Cantuareberi
Her cuom se herian|here|heran toh|to readingum on|an West.Seaxe
& se ymb þri niht|neaht ridan twegen eorl up
Þa gemetan hi|heo æþelwulf ealdorman on|an englafeld & him|hi|he þær wiþ gefeohtan|feссan & sige|sigan|seon nam
Þæs ymb feower niht|neaht æþered cyning & ælfred hit|his|he broðor þær micel fierd toh|to readingum gelædan & wiþ se herian|here|heran gefuhton
& þær wesan|seon|beon micel wæl|wel slean|geslean on|an gehwæðer hond
& æþelwulf ealdorman weorþan ofslægen
& þu|þa|se deniscan|denisc agan wælstow gewald
& se ymb feower niht|neaht gefeohtan|feссan æþered cyning & ælfred hit|his|he broðor wiþ eal|all se herian|here|heran on|an Æscesdune
& hi|heo wærun on|an twæman|twegen gefylcum
on oþrum|oþer|oðer wesan|seon|beon bagsecg & halfdene þu|þa|se hæþen|hæðen cyningas
& on|an oþrum|oþer|oðer wesan|seon|beon þu|þa|se eorlas
& þu|þa|se gefeohtan|feссan se cyning æþered wiþ þær|se cyning getruman
& þær weorþan se cyning bagsecg ofslægen
& ælfred hit|his|he broðor wiþ þær|se eorl getruman
& þær weorþan sidroc eorl ofslean se ald & sidroc eorl se gioncga & osbearn eorl & fræna eorl & hareld eorl
& þu|þa|se here begen gefliemde
& fela þusend ofslægenra
& onfeohtan wesan|seon|beon oþ niht
& se ymb feowertyne niht|neaht gefeohtan|feссan æþered cyning & ælfred hit|his|he broður|broðor wiþ se herian|here|heran æt|etan Basengum
& þær þu|þa|se deniscan|denisc sige|sigan|seon namon
& se ymb twegen monaþ gefeohtan|feссan æþered cyning & ælfred hit|his|he broðor wiþ se herian|here|heran æt|etan Meretune
& hi|heo wærun on|an twegen gefylcium
& hi|heo butu geflyman & long|lange on|an dæg sige|sigan|seon ahton
& þær weorþan micel wælsliht on|an gehwæðer hond
& þu|þa|se deniscan|denisc agan wælstow gewald
& þær weorþan heahmund bisceop ofslean & fela god monna
& æfter þes gefeohtan|gefeoht cuom micel sumorlida
& se ofer easter gefaran æþered cyning
& he ricsian fif gear
& hit|his|he liс|lic liþan|liþ æt|etan Winburnan
Þa fon ælfred æþelwulfing hit|his|he broðor toh|to west-seaxe rice
& se ymb an monaþ gefeohtan|feссan ælfred cyning wiþ eal|all se herian|here|heran lytel werian|weorod æt|etan wiltun & he long|lange on|an dæg gefliemde
& þu|þa|se deniscan|denisc agan wælstow gewald
& se gear wurdon|weorþan nigon folcgefeoht gefeohtan|feohtan wiþ se herian|here|heran on|an þywan|þy|þe|se cynerice be suþan|suþ temesemuþa|temese|temes & butan þæm|þam|se þu|þe|se him|hi|he ælfred se cyning broðor & anlipig ealdorman & cyning þegn|þegen oft rad onridan þu|þe|se mann|man na nesan|neh|ne rimde
& se gear wærun ofslean|ofslagan nigon eorl & on|an cyning
& þywan|þy|þe|se geare|gear niman west-seaxe friþ wiþ se here
Her for|faran se herian|here|heran toh|to lundenburh from|fram readingum & þær wintersetl nam
& þu|þa|se niman mirce friþ wiþ se here
Her for|faran se herian|here|heran on|an Norþhymbre
& he niman wintersetl on|an lindesse æt|etan turec iege
& þu|þa|se niman mirce friþ wiþ se here
Her for|faran se herian|here|heran from|fram lindesse toh|to hreopedun & þær wintersetl niman & se cyning burgred ofer sæ adræfan ymb twentigtwegen wintra|winter se þu|þe|se he romana habban & þæt|se land eal|all geeodon
& he for|faran toh|to rom & þær gesæt
& hit|his|he liс|lic liþan|liþ on|an sancta marian|maria cirice on|an angelcynn scole
& þywan|þy|þe|se ilca geare|gear hi|heo sellan an unwis cyning þegn|þegen mirce romana toh|to haldanne
& he him|hi|he aþ swerian & gisl|gisel salde þæt|se he him|hi|he gearu|gearo wære|wær|wesan|seon|beon swa hwilc dæge|dæg swa hi|heo hit habban willan & he gearu|gearo wære|wær|wesan|seon|beon mid him|hi|he self & on|an eal|all þæm|þam|se þu|þe|se him|hi|he læstan|læst willan toh|to se heres þearfe
Her for|faran se herian|here|heran from|fram Hreopedune
& halfdene for|faran mid sum þæm|þam|se herian|here|heran on|an norþan-hymbre & niman wintersetl be tina þære|se ea
& se herian|here|heran þæt|se land gegan & oft hergian on|an peohtas & on|an stræcled Walas
& for|faran godrum & oscytel & anwynd þu|þa|se þri cyning of hreopedun toh|to grantebrycg mid micel herian|here|heran & sittan þær on|an gear
& þywan|þy|þe|se sumer for|faran ælfred cyning ut on|an sæ mid sciphere & gefeohtan|feссan wiþ seofon sciphlæst & hira|hi on|an gefon|gefeng & þu|þa|se oþer|oðer gefliemde
Her he bestelan se herian|here|heran into werham west-seaxe fierde
& wiþ se herian|here|heran se cyning friþ nam
& him|hi|he þu|þa|se aþ swerian on|an þæm|þam|se halig|halga|haleg beah|beag þu|þe|se hi|heo ær nan þeon|þeodan|þeod næs|ne oldon þæt|se hi|heo hrædlice of hit|his|he romana foren
& hi|heo þu|þa|se under þæm|þam|se hi|heo niht bestelan þære|se fierd se gehorsian herian|here|heran into Escanceaster
& þywan|þy|þe|se geare|gear halfdene norþan-hymbre land gedælde
& ergende wesan|seon|beon & hira|hi tilgende
Her cuom se herian|here|heran into exanceaster from|fram Werham
& se sciphere seglan westan|west|wesan ymbutan
& þu|þa|se metan hi|heo micel yþan|ystan|yst on|an sæ
& þær forweorþan hundtwelftig scip æt|etan Swanawic
& se cyning ælfred æfter þæm|þam|se gehorsian herian|here|heran mid fierd ridan|rad oþ exanceaster & hi|heo hindan ofridan nesan|neh|ne magan ær hi|heo on|an þæm|þam|se fæsten wesan|seon|beon þær him|hi|he mann|man toh|to nesan|neh|ne meahte
& hi|heo him|hi|he þær foregisel saldon swa fela swa he habban willan & micel aþ swerian & þu|þa|se god friþ heoldon
& þu|þa|se on|an hærfest gefaran se herian|here|heran on|an mirce land & hit gedælan sum|su & sum|su ceolwulf saldon
Her he bestelan se herian|here|heran on|an midd winter ofer twelfta niht|neaht toh|to cippanham & geridan west-seaxe land & gesittan micel se folc & ofer sæ adræfdon
& se oþer|oðer se micel dælan|dæl hi|heo geridan & him|hi|he toh|to gecirran butan þæm|þam|se cyninge|cyning Ælfrede
& he lytel werian|weorod uneaðelíce æfter wudu for|faran & on|an morfæstenum
& se ilca wintra|winter wesan|seon|beon inwær broðor & halfdene on|an west-seaxe on|an defena mid twentigþri scipum
& he mann|man þær ofslean & eahtahund mann mid him|hi|he & feowertig mann hit|his|he heres
& se on|an easter wyrсean|wyrсan|wyrcan ælfred cyning lytel werian|weorod geweorc æt|etan æðeling ig & of þæm|þam|se geweorc was winnan wiþ se herian|here|heran & sumersæte se dælan|dæl se þær neah wæs
Þa on|an þære|se seofoþa wicu ofer easter he geridan|gerad toh|to ecgbryht stane|stan be eastan|east Sealwyda
& him|hi|he toh|to cuman þær ongeagn sumersæte eal|all & wilsætan & hamtunscir se dælan|dæl se hiere|hieran beheonan sæ was & hit|his|he gefægen wærun
& he for|faran ymb an niht|neaht of þæm|þam|se wiсe|wiс|wicu|wice|wic toh|to iglea & se ymb an toh|to eþandun & þær gefeohtan|feссan wiþ eal|all se herian|here|heran & he geflyman & him|hi|he æfter ridan|rad oþ þæt|se geweorc & þær sæt|sittan feowertyne niht
& þu|þa|se salde se herian|here|heran him|hi|he foregisel & micel aþ þæt|se hi|heo of hit|his|he romana uuoldon & him|hi|he eacan|eac gehatan þæt|se hira|hi kyning fulwihtan|fulwiht onfon wolde
& hi|heo þæt|se gelæstan swa
& se ymb þri wicu cuman se cyning toh|to him|hi|he godrum þritig sum|su þær|se mann þu|þe|se in þæm|þam|se herian|here|heran weorþ wesan|seon|beon æt|etan Alre
& þæt|se wesan|seon|is wiþ æðeling eige
& hit|his|he se cyning þær onfon æt|etan fulwihte
& hit|his|he crismlysing was æt|etan Weþmor
& he was twelf niht|neaht mid þæm|þam|se cyninge
& he he micel & hit|his|he gefere|gefera mid feoh weorðude
Her for|faran se herian|here|heran toh|to cirenceaster of cippanham & sæt|sittan þær on|an gear
& þywan|þy|þe|se geare|gear gegaderian on|an hloþ wicing & gesittan æt|etan fullanham be Temese
& þywan|þy|þe|se ilca geare|gear aþystrian se sunne|sinnan an tidan|tid dæges
Her for|faran se herian|here|heran of cirenceaster on|an east-engle & gesittan þæt|se land & gedælde
& þywan|þy|þe|se ilca geare|gear for|faran se herian|here|heran ofer sæ þu|þe|se ær on|an fullanham sæt|sittan on|an francland toh|to gend & sæt|sittan þær on|an gear
Her for|faran se herian|here|heran ufor on|an Fronclond
& þu|þa|se francan him|hi|he wiþ gefuhton
& þær þu|þa|se weorþan se herian|here|heran gehorsian æfter þæm|þam|se gefeohte
Her for|faran se herian|here|heran up andlang mæs feor on|an francland & þær sæt|sittan on|an gear
& þywan|þy|þe|se ilca geare|gear for|faran ælfred cyning mid scip ut on|an sæ & gefeohtan|feссan wiþ feower sciphlæst denisc mann & þær|se scip twegen genam
& þu|þa|se mann ofslean|ofslagan wesan|seon|beon þu|þe|se þæron wæron
& twegen sciphlæst him|hi|he on|an hond eodon
& þu|þa|se wesan|seon|beon micel forslean & forwundian ær hi|heo on|an hond eodon
Her for|faran se herian|here|heran up on|an scald toh|to cundoþ & þær sæt|sittan on|an gear
Her for|faran se herian|here|heran up on|an sunna toh|to embene & þær sæt|sittan on|an gear
Her todælan se foresprecen herian|here|heran on|an twegen oþer|oðer dælan|dæl east oþer|oðer dælan|dæl toh|to Hrofesceastre
& ymbsittan þe|þa|ða|se ceaster & wyrсean|wyrсan|wyrcan oþer|oðer fæsten|fæstan ymb hi|heo selfe
& hi|heo þiсgan|þicgan|þeon|þeah þu|þa|se ceaster awerian oþ þæt|se ælfred cuman utan mid fierde
Þa gan|eadan se herian|here|heran toh|to hira|hi scip & forlætan þæt|se geweorc
& hi|heo wurdon|weorþan þær behorsian & sona þywan|þy|þe|se ilca sumer ofer sæ gewiton
& þywan|þy|þe|se ilca geare|gear sendan ælfred cyning sciphere on|an East.Engle
sona swa hi|heo cuman on|an stufemuþa þu|þa|se metan hi|heo syxtyne scip wicing & wiþ þe|þa|ða|se gefeohtan & þu|þa|se scipo eal|all geræcan & þu|þa|se mann ofslogon
Þa hi|heo þu|þa|se hamweard wendan|wenan mid þære|se herehyþ þu|þa|se metan hi|heo micelne|micel sciphere wicing & þu|þa|se wiþ þu|þa|se gefeohtan þywan|þy|þe|se ilca dæge
& þu|þa|se deniscan|denisc agan sige
Þy ilca geare|gear ær midde|midd wintra|winter forþferan carl francan cyning
& he ofslean on|an efor
& an geare|gear ær hit|his|he broður|broðor forþferan se habban eacan|eac þæt|se westrice
& hi|heo wesan|seon|beon begen hloþwig suna
Se habban eacan|eac þæt|se westrice & forþferan þywan|þy|þe|se geare|gear þu|þe|se se sunne|sinnan aþiestrode
Se wesan|seon|beon carl sunu þu|þe|se æþelwulf west-seaxe cyning hit|his|he dohtor habban him|hi|he toh|to cuene
& þywan|þy|þe|se ilca geare|gear gegaderian micel sciphere on|an Aldseaxum
& þær weorþan micel gefeohtan|gefeoht twiwa on|an geare
& þu|þa|se seaxe hæfdun sige
& þær wesan|seon|beon frysa mid
Þy ilca geare|gear fon carl toh|to þæm|þam|se westrice & toh|to eal|all þæm|þam|se westrice beheonan wendelsæ & begeondan þes sæ swa hit hit|his|he þridda fæder habban butan Lidwiccium
Se carl was hloþwig sunu
se hloþwig was carl broðor se wesan|seon|beon iuþytt fæder þu|þe|se æþelwulf cyning hæfde
& hi|heo wesan|seon|beon hloþwig suna
se hloþwig was se ald carl sunu
se carl was pippen sunu
& þywan|þy|þe|se ilca geare|gear forþferan se god papa marinus se gefreoogan angelcynn scolu|scol be ælfred ben west-seaxe cyninges
& he sendan him|hi|he micel gifu & þære|se rode|rod dælan|dæl þu|þe|se crist|Crist on|an þrowude
& þywan|þy|þe|se ilca geare|gear se herian|here|heran on|an east-engle brecan friþ wiþ ælfred cyning
Her for|faran se herian|here|heran eft westan|west|wesan þu|þe|se ær east gelende|gelendan & þu|þa|se up on|an sigen & þær wintersetl namon
Þy ilca geare|gear gesette|gesettan ælfred cyning Lundenburg
& him|hi|he eal|all angelcynn toh|to cyrran þæt|se butan denisc mann hæftned was
& hi|heo þu|þa|se befæstan þu|þa|se cantwara|burg æþered ealdorman toh|to haldonne
Her for|faran se herian|here|heran up þurh þu|þa|se brycge æt|etan paris & þu|þa|se up andlang sigen oþ mæterne oþ cariei & þu|þa|se sittan þær|se & innan ione twegen winter on|an þæm|þam|se twegen stedum
& þywan|þy|þe|se ilca geare|gear forþferan carl francan cyning
& earnulf hit|his|he broðor sunu he six wiсe|wiс|wicu|wice|wic ær he forþferan berædan æt|etan þæm|þam|se rice
& þu|þa|se weorþan þæt|se romana todælan on|an fif & fif kyning toh|to gehalgode
Þæt wesan|seon|beon þiсgan|þicgan|þeon|þeah mid earnulf geþafunge
& hi|heo cuædon þæt|se hi|heo þæt|se toh|to hit|his|he honda healdan|heald sculan forðam hira|hi nan næs|ne æs on|an fæderenhealf toh|to geboren|geberan|beran butan him|hi|he anum
Earnulf þu|þa|se wunian on|an þæm|se land be eastan|east Rin
& roþulf þu|þa|se fon toh|to þæm|se middelrice & oda toh|to þæm|se westdæl & beorngar & wiþa toh|to langbeardas land & toh|to þæm|se land on|an þu|þa|se healf muntes
& þæt|se heoldun mid micel unsib & twegen folcgefeoht gefeohtan & þæt|se land oft & gelome|gelom forhergodon
& æghwæðer oþer|oðer oftrædlice ut dræfde
& þywan|þy|þe|se ilca geare|gear þu|þe|se se herian|here|heran for|faran forþ up ofer þu|þa|se brycge æt|etan paris æþelhelm ealdorman lædan west-seaxe ælmesse & ælfred cyning toh|to Rome
Her lædan beocca ealdorman west-seaxe ælmesse & ælfred cyning toh|to Rome
& æþelswiþ cuen se wesan|seon|beon ælfred sweostor cyning forþferde
& hire|heo liс|lic liþan|liþ æt|etan Pafian
& þywan|þy|þe|se ilca geare|gear æþelred arcebisceop & æþelwald ealdorman forþferan on|an an monþe
On þes geare|gear næs|ne æs nan færeld toh|to rom butan twegen hleapere ælfred cyning sendan mid gewritum
Her lædan beornhelm abbad west-seaxe ælmesse toh|to rom & ælfred cyninges
& godrum se norþerne cyning forþferan se fulluhtnama wesan|seon|beon æþelstan se wesan|seon|beon ælfred cyning godsunu
& he buan|beodan on|an east-engle & þæt|se land ærest|ær gesæt
& þywan|þy|þe|se ilca geare|gear for|faran se herian|here|heran of sigen toh|to sant þæt|se wesan|seon|is betweoh bryttas & Francum
& bryttas him|hi|he wiþ gefeohtan & habban sige|sigan|seon & hi|heo bedrifan ut on|an an ea & manig adrencton
Her wesan|seon|beon plegemund geceosan of god & of eal hit|his|he halechen
Her for|faran se herian|here|heran east
& earnulf cyning gefeohtan|feссan wiþ|wið þæm|se rædehere ær þu|þa|se scip cuomon mid east-francan & seaxe & bægere & he gefliemde
& þrie|þri scottas cuman toh|to ælfred cyninge|cyning on|an an bat butan ælc gereþru of hibernia þanan hi|heo hi|heo bestelan forðam þu|þe|se hi|heo willan for|faran godes|god lufu|lufe on|an elþeodignes beon
hi nesan|neh|ne reссan|reccan|recan hwær
Se bitan|bat wesan|seon|beon wyrсean|wyrсan|wyrcan|gewyrсean|gewyrсan|gewyrcan of þridda healf hydan|hyd þu|þe|se hi|heo on|an foron
& hi|heo niman mid him|hi|he þæt|se hi|heo hæfdun toh|to seofon niht|neaht mete
& þu|þa|se cuman hi|heo ymb seofon niht|neaht toh|to land on|an cornwealas & faran þu|þa|se sona toh|to ælfred cyninge
Þus hi|heo wesan|seon|beon genemnan dubslane & maccbethu & Maelinmun
& swifneh se god lareow þu|þe|se on|an scottas wesan|seon|beon gefor
& þywan|þy|þe|se ilca geare|gear ofer easter ymbe|ymb gangdagas oþþe|oððe ær æteowian se steorra þu|þe|se mann|man on|an bocleden hætan|hatan cometa
Same mann cweþan on|an englisc|Englisc þæt|se hit wesan|seon|nesan feaxede steorra forðam þær standan lang leoma of hwilum|hwil on|an an healf hwilum|hwil on|an ælc healfe
Her on|an þes geare|gear for|faran se micel herian|here|heran þu|þe|se we gefyrn ymbe|ymb sprecan eft of þæm|se eastrice westweard toh|to bune & þær wurdon|weorþan gescipian swa þæt|se hi|heo asettan him|hi|he on|an an siþ ofer mid hors mid ealle|eall|eal & þu|þa|se cuman up on|an limene muþa mid twegenhundfiftig hund scipa
Se muþa|muþ wesan|seon|is on|an easteweard cent æt|etan se micel wudu|wudian eastende þu|þe|se we andred hatað
se wudu wesan|seon|is eastlang & westlang hundtwelftig mil lang oþþe|oððe lengra & þritig mil brad
seo ea þu|þe|se we ær ymbe|ymb sprecan lið ut of þæm|se wealda
On þu|þa|se ea hi|heo teon up hira|hi scip oþ se wealdan|weald feower mil fram þæm|se muþa uteweard & þær abrecan on|an geweorc
inne on|an þæm|se fæsten|fæstan sittan feawa|feaw ceorlisc mann on
& wesan|seon|beon samworht
Þa sona æfter þæm|se cuman hæsten mid hundeahtatig scip up on|an temesemuþa|temese|temes muðan & wyrсean|wyrсan|wyrcan him|hi|he geweorc æt|etan Middeltune
& se oþer|oðer herian|here|heran æt|etan Apuldre
On þis geare|gear þæt|se wesan|seon|beon ymb twelf monaþ|monað se þu|þe|se hi|heo on|an þæm|se eastrice geweorc wyrсean|wyrсan|wyrcan|gewyrсean|gewyrсan|gewyrcan habban norþan-hymbre & east-engle habban ælfred cyninge|cyning aþ sellan|gesellan|geseald & east-engle foregisel vi
& þeah ofer þu|þa|se treowe|treow swa oft swa þu|þa|se oþer|oðer here mid ealle|eall|eal herian|here ut faran þonne|se faran hi|heo oþþe|oððe mid oþþe|oððe on|an hira|hi|heore healf on
Þa gegaderian ælfred cyning hit|his|he fierd & for|faran þæt|se he gewician betweoh þæm|se twegen here þær þær he neah rymet habban for|faran wudufæsten and for|faran wæterfæsten swa þæt|se he magan æghwæðer geræcan gif hi|heo ænig feld sec wolden
Þa faran hi|heo siððan æfter þæm|se weald hloþ & flocrad bi|be swa hwæðer efes swa hit þonne|se fierdleas wæs
& him|hi|he mann|man eacan|eac mid oþrum|oþer|oðer flocc sœ̄сan|seсan|secan micel dæg|dah|dagian|dag ælc oþþe|oððe on|an dæg oþþe|oððe on|an niht|neaht ge of þære|se fierd ge eacan|eac of þæm|se burgum
Hæfde se cyning hit|his|he fierd on|an twegen toniman swa þæt|se hi|heo wesan|seon|beon simble healf æt|etan ham healf ute butan þæm|se mann þu|þe|se þu|þa|se burh|burg healdan|heald scolden
Ne cuman se herian|here|heran oft eall|eal ute of þæm|se set þonne|se twiwa oþer|oðer siþ þu|þa|se hi|heo ærest|ær toh|to land cuman ær se fierd samnian|gesamnian wære|wær|wesan|seon|beon oþer|oðer siþ þu|þa|se hi|heo of þæm|se set faran woldon
Þa hi|heo gefon micel herehyþ & þu|þa|se willan ferian norþeweard ofer temesemuþa|temese|temes in on|an east-seaxe ongeagn þu|þa|se scipu
Þa forridan se fierd hi|heo foran & him|hi|he wiþ|wið gefeohtan|feссan æt|etan fearnham & se herian|here|heran geflyman & þu|þa|se herehyþ ahreddon
& hi|heo fleon|fleogan ofer temesemuþa|temese|temes butan ælc ford þu|þa|se up be coln on|an an iggað
Þa besittan se fierd hi|heo þær utan þu|þa|se hwil þu|þe|se hi|heo þær lengest|lengan|lange mete|metan|met hæfdon
Ac hi|heo habban þu|þa|se hira|hi|heore stemn|stefn gesittan & hira|hi mete|metan|met genotudne
& wesan|seon|beon se cyng þu|þa|se þiderweardes on|an fær mid þære|se scir þu|þe|se mid him|hi|he fierdedon
Þa he þu|þa|se wesan|seon|beon þiderweardes & se oðer fierd wesan|seon|beon hamweardes
& þe|þa|ða|se deniscan|denisc sittan þær behindan forðam hira|hi cyning wesan|seon|beon wundian|gewundian on|an þæm|se gefeohtan|gefeoht þæt|se hi|heo he nesan|neh|ne magan ferian
Þa gegaderian þu|þa|se þu|þe|se in norþan-hymbre bugeað & on|an east-engle sum|su hund|1000 scip & faran suþ ymbutan & sum|su feowertig scip norþ ymbutan & ymbsittan on|an geweorc on|an defena be þære|se norþ.sæ
& þu|þa|se þu|þe|se suþ ymbutan faran ymbsittan Exancester
Þa se cyng þæt|se hyran|hierde|hierdan|hieran þu|þa|se wendan|wenan he he westan|west|wesan wiþ|wið exanceaster mid eall|eal þære|se fierd butan swiþe|swiþan|swiþ|swiðe gewealden dælan|dæl easteweard se folces
Þa faran forþ|forð oþ þu|þe|se hi|heo cuman toh|to lundenburh & þu|þa|se mid þæm|se burhware & þæm|se fultuman|fultum þu|þe|se him|hi|he weste|westan cuman faran east toh|to Beamfleote
Wæs hæsten þu|þa|se þær cuman mid hit|his|he here þu|þe|se ær æt|etan middeltun sæt
& eacan|eac se micel herian|here|heran wesan|seon|beon þu|þa|se þær tocuman þu|þe|se ær on|an limene muþa sæt|sittan æt|etan Apuldre
Hæfde hæsten ær wyrсean|wyrсan|wyrcan|gewyrсean|gewyrсan|gewyrcan þæt|se geweorc æt|etan beamfleot & wesan|seon|beon þu|þa|se ut afaran on|an hergaþ
& wesan|seon|beon se micel herian|here|heran æt|etan ham
Þa faran hi|heo toh|to & geflyman se herian|here|heran & þæt|se geweorc abrecan & geniman eal þæt|se þær binnan wesan|seon|beon ge on|an feoh ge on|an wif ge eacan|eac on|an bearn & bringan|brengan eall|eal in toh|to lundenburh & þu|þa|se scip eall|eal oððe tobrecan oþþe|oððe forbærnan oþþe|oððe toh|to lundenburh bringan|brengan oþþe|oððe toh|to Hrofesceastre
& hæsten wif & hit|his|he sunu twegen mann|man bringan|brengan toh|to þæm|se cyninge
& he hi|heo him|hi|he eft agifan|agiefan forðam þu|þe|se hira|hi wesan|seon|beon oþer|oðer hit|his|he godsunu oþer|oðer æþered ealdormonnes
Hæfdon hi|heo hira|hi onfon ær hæsten toh|to beamfleot come
& he him|hi|he habban sellan|gesellan|geseald gisl|gisel & aðas
& se cyng him|hi|he eacan|eac wel feoh sellan & eacan|eac swa þu|þa|se he se cniht agef & þæt|se wif
Ac sona swa hi|heo toh|to beamfleot cuman & þæt|se geweorc wyrсean|wyrсan|wyrcan|gewyrсean|gewyrсan|gewyrcan wesan|seon|beon swa hergian he on|an hit|his|he romana se ilca ende þu|þe|se æþered hit|his|he cumpæder healdan|heald sceolde
& eft oþer|oðer siþ he wesan|seon|beon on|an hergaþ gelendan on|an þæt|se ilca romana þu|þa|se þu|þa|se mann|man hit|his|he geweorc abræc
Þa se cyning he þu|þa|se westan|west|wesan wendan|wenan mid þære|se fierd wiþ|wið exanceaster swa ic ær sæde
& se herian|here|heran þu|þa|se cantwara|burg besittan hæfde
Þa he þær tofaran wesan|seon|beon þu|þa|se gan|eadan hi|heo toh|to hira|hi scipum
Þa he þu|þa|se wiþ|wið se herian|here|heran þær wæþan|west abisgian wesan|seon|beon & þu|þa|se here wesan|seon|beon þu|þa|se gegaderian begen toh|to sceoburh on|an east-seaxe & þær geweorc worhtun
Foron begen ætgædere up be Temese
& him|hi|he cuman micel eaca toh|to æghwæðer ge of east-engle ge of Norþhymbrum
Foron þu|þa|se up be temesemuþa|temese|temes oþ þæt|se hi|heo gedon æt|etan Sæferne
þa up be Sæferne
Þa gegaderian æþered ealdorman & æþelm ealdorman & æþelnoþ ealdorman & þu|þa|se cinges þegn|þegen þu|þe|se þu|þa|se æt|etan ham æt|etan þæm|se geweorc wesan|seon|beon of ælс|ælc burh|burg be eastan|east pedrida ge be weste|westan sealhwudu ge be eastan|east ge eacan|eac be norþan|norþ temesemuþa|temese|temes & be weste|westan sæfern ge eacan|eac sum|su dælan|dæl se Norð.Weal.cynnes
Þa hi|heo þu|þa|se ealle|eall|eal gegaderian wesan|seon|beon þu|þa|se offaran hi|heo se herian|here|heran hindan æt|etan buttingtun on|an sæfern stæþ & he þær utan besittan on|an ælc healf on|an an fæstenne
Þa hi|heo þe|þa|ða|se fela wicu sittan on|an twegen|twa healf þære|se flet & se cyng wesan|seon|beon westan|west|wesan on|an defenas wiþ se sciphere þu|þa|se wesan|seon|beon hi|heo mid meteleast gewægan & habban micel dælan|dæl þær|se hors freten
& þu|þa|se oþer|oðer wesan|seon|beon hungor acwolen
Þa gan|eadan hi|heo ut toh|to þæm|se mann þu|þe|se on|an easthealf þære|se flet wician & him|hi|he wiþ gefuhton
& þu|þa|se cristen habban sige
& þær wearð ordheh cyning þegn ofslean & eacan|eac manig oþer|oðer cyning þegnas
& þær|se denisc þær wearð swiþe|swiþan|swiþ|swiðe micel wæl|wel geslegen
& se dælan|dæl þu|þe|se þær aweg cuman wurdon|weorþan on|an fleam generede
Þa hi|heo on|an east-seaxe cuman toh|to hira|hi geweorc & toh|to hira|hi scip þu|þa|se gegaderian se laf eft of east-engle & of norþan-hymbre micelne|micel herian|here|heran onforan winter & befæstan hira|hi wif & hira|hi scip & hira|hi feoh on|an east-engle & faran anstreces dæg & niht þæt|se hi|heo gedon on|an an weste|west ceaster on|an wirhealh seon|seo|se wesan|seon|is legaceaster gehaten
Þa nesan|neh|ne magan seon|seo|se fird hi|heo na hindan offaran ær hi|heo wesan|seon|beon inne on|an þæm|se geweorce
Besæton þiсgan|þicgan|þeon|þeah þæt|se geweorc utan sum twegen dæg|dah|dag & geniman ceap eall|eal þæt|se þær butan wesan|seon|beon & þu|þa|se mann ofslean þu|þe|se hi|heo foran forridan magan butan geweorc & þæt|se corn eall|eal forbærnan & mid hira|hi hors frettan on|an ælс|ælc efenehðe
& þæt|se wesan|seon|beon ymb twelf monaþ|monað se þu|þe|se hi|heo ær hider ofer sæ comon
Ond þu|þa|se sona æfter þæm|se on|an þes gear for|faran se herian|here|heran of wirhealh in on|an norþ-walas forðam hi|heo þær sittan nesan|neh|ne mehton
þæt wesan|seon|beon forði þu|þe|se hi|heo wesan|seon|beon beniman æghwæðer ge se ceap ge se corn þu|þe|ðe hi|heo hergian|gehergian hæfdon
Þa hi|heo þe|þa|ða|se eft ut of norþ-walas wendan|wenan mid þære|se herehyþ þu|þe|se hi|heo þær niman|geniman habban þu|þa|se faran hi|heo ofer norþan-hymbre land & east-engle swa swa se fird hi|heo geræcan nesan|neh|ne magan oþ þæt|se hi|heo cuman on|an east-seaxe land easteweard on|an on|an igland þæt|se wesan|seon|is ute on|an þære|se sæ þæt|se wesan|seon|is Meres ig haten
& þu|þa|se se herian|here|heran eft hamweard wendan|wenan þu|þe|se exanceaster besittan habban þu|þa|se hergian hi|heo up on|an suþ-seaxe neah Cisseceastre
& þu|þa|se burhware hi|heo geflyman & hira|hi manig hund|1000 ofslean & hira|hi scip sum genamon
Ða þywan|þy|þe|se ilca gear onforan winter þu|þa|se deniscan|denisc þu|þe|se on|an Meres ig sittan teon hira|hi scip up on|an temesemuþa|temese|temes & þu|þa|se up on|an Lygan
þæt wesan|seon|beon ymb twegen|twa gear se þu|þe|se hi|heo hider ofer sæ comon
On þywan|þy|þe|se ilca gear wyrсean|wyrсan|wyrcan se foresprecen herian|here|heran geweorc be lyge twentig mil bufan Lundenbyrig
Þa se on|an sumer faran micel dælan|dæl þær|se burhware & eacan|eac swa oþer|oðer folc þæt|se hi|heo gedon æt|etan þær|se deniscan geweorc & þær wurdon|weorþan gefliemde
& sum feower cyning þegn|þegen ofslægene
Þa se on|an hærfest þu|þa|se wician se cyng on|an neahwest se burh|burg þu|þa|se hwil þu|þe|se hi|heo hira|hi corn geripan þæt|se þu|þa|se deniscan|denisc him|hi|he nesan|neh|ne magan se ripe|rip forwiernan
Þa sum dæge|dæg ridan|rad se cyng up be þære|se eæ & gehawian hwær mann|man magan þu|þa|se ea forwyrcan þæt|se hi|heo nesan|neh|ne magan þu|þa|se scip ut brengan
& hi|heo þe|þa|ða|se swa dydon
worhton þe|þa|ða|se twegen geweorc on|an twegen|twa healf þære|se eas
Þa hi|heo þe|þa|ða|se þæt|se geweorc furþum onginnan habban & þærto gewician habban þu|þa|se ongitan se herian|here|heran þæt|se hi|heo nesan|neh|ne magan þu|þa|se scypu ut brengan
Þa forlætan hi|heo hi|heo & gan|eadan ofer land|finna þæt|se hi|heo gedon æt|etan cwatbrycg be sæfern & þær gewerc worhton
Þa ridan|rad seon|seo|se fird westan|west|wesan æfter þæm|se herige
& þu|þa|se mann of lundenburh gefetian þu|þa|se scip & þu|þa|se ealle|eall|eal þu|þe|se hi|heo alædan nesan|neh|ne magan tobrecan & þu|þa|se þu|þe|se þær stælwirðe wesan|seon|beon binnan lundenburh gebrohton
& þu|þa|se deniscan|denisc habban hira|hi wif befæstan innan east-engle ær hi|heo ut of þæm|se geweorc foron
Þa sittan hi|heo se winter æt|etan Cwatbrycge
Þæt wesan|seon|beon ymb þri gear se þu|þe|se hi|heo on|an limene muðan cuman hider ofer sæ
Ða se on|an sumer on|an þes gear tofaran se herian|here|heran sum|su on|an east-engle sum|su on|an Norðhymbre
& þu|þa|se þu|þe|se feohleas wesan|seon|beon him|hi|he þær scip begitan & suþ ofer sæ faran toh|to Sigene
N æfde se herian|here|heran godes|god þanc angelcynn eall|eal forswiðe gebrocod
Ac hi|heo wesan|seon|beon micel swiðe gebrocian on|an þæm|se þri gear mid ceap cwyld|cwild & mann eall|eal swiðe mid þæm|se þæt|se manig|manian þær|se sel cyng þenian þu|þe|se þær on|an land wesan|seon|beon forþferan on|an þæm|se þri gearum
Þara wesan|seon|beon sum|su swiþulf bisceop on|an hrofesceaster & ceolmund ealdorman on|an cent & beorhtulf ealdorman on|an east-seaxe & wulfred ealdorman on|an hamtunscir & ealhheard bisceop æt|etan dorceceaster & eadulf cyng þegn on|an suþ-seaxe & beornulf wicgerefa on|an wintanceaster & ecgulf cyng horsþegn & manig|manian eacan|eac him|hi|he þeah ic þe|þa|ða|se geþungen nemde
Þy ilca geare|gear dreссan þu|þa|se here on|an east-engle & on|an norþan-hymbre west-seaxe land swiðe|swiðan be þæm|se suþstæþ mid stælhere eall|eal swiðe mid þæm|se æsc þu|þe|se hi|heo fela gear ær timbredon
Þa hettan|het|hedan|hatan ælfred cyng timbran langscip ongeagn þe|þa|ða|se æscas
þa wesan|seon|beon fulneah twegen swa lange|lang swa þu|þa|se oðru
sume habban sixtig arian|ar sum ma
Þa wesan|seon|beon æghwæðer ge swift ge unwealt ge eacan|eac hieran þonne|se þu|þa|se oðru
n æron nahwæðer nesan|neh|ne on|an fresisc gesceppan nesan|neh|ne on|an denisc bute swa him|hi|he self ðuhte þæt|se hi|heo nytweorð beon|beo|bannan meahten
Þa æt|etan sum cyrr se ilca gear cuman þær six scip toh|to wiht & þær micel yfel gedon æghwæðer ge on|an defenas ge welhwær be þæm|se sæ.riman
Þa hettan|het|hedan|hatan se cyng faran mid nigon toh|to þær|se niwe scipa
& forfaran him|hi|he se muðan foran on|an utermere
Þa faran hi|heo mid þri scip ut ongeagn hie
& þri standan æt|etan ufeweard þæm|se muðan on|an drygum
wæron þu|þa|se mann uppe on|an land of agane
þa gefon hi|heo þær|se þri scip twegen æt|etan þæm|se muðan uteweard & þu|þa|se mann ofslogon
& þæt|se on|an oðwand
On þæm|se wesan|seon|beon eacan|eac þu|þa|se mann ofslean|ofslagan butan fifum
Þa cuman forði onweg þu|þe|ðe se oþer|oðer scip asæton
þa wurdon|weorþan eacan|eac swiðe|swiðan uneðelice aseten
Þreo asittan on|an þe|þa|ða|se healf se deop þu|þe|ðe þe|þa|ða|se deniscan|denisc scip asittan|aseten wesan|seon|beon & þu|þa|se oðer eall|eal on|an oþer|oðer healf þæt|se hira|hi nesan|neh|ne magan nan toh|to oðrum
Ac þe|þa|ða|se þæt|se wæter wesan|seon|beon ahebban fela furlang from|fram þæm|se scip þu|þa|se eodan þe|þa|ða|se deniscan|denisc from|fram þæm|se þri scip toh|to þæm|se oðer þri þu|þe|se on|an hira|hi healf beebbian wæron
& hi|heo þu|þa|se þær gefuhton
Þær wearð ofslean lucumon cyng gerefa & wulfheard frysa & æbbe frysa & æþelhere frysa & æþelferþ cyng geneat & eall|eal mann fresisc & englisc|Englisc sixtigtwegen & þær|se deniscan cxx
þa cuman þæm|se denisc scip þeah ær flod toh|to ær þu|þa|se cristen magan hira|hi utascufan
& hi|heo forði ut oðreowon
Þa wesan|seon|beon hi|heo toh|to þæm|se gesargian þæt|se hi|heo nesan|neh|ne magan suþ-seaxe land utan berowan
ac hira|hi þær twegen sæ on|an land wearp
& þu|þa|se mann mann|man lædan toh|to wintanceaster toh|to þæm|se cynge
& he hi|heo þær ahon het
& þu|þa|se mann cuman on|an east-engle þu|þe|se on|an þæm|se an scip wesan|seon|beon swiðe|swiðan forwundode
Þy ilca sumer forwearð nealles þonne|se twentig scip mid mann mid ealle|eall|eal be þæm|þam|se suð.riman
Þy ilca gear forþferan wulfric cyng horsþegn se wesan|seon|beon eacan|eac wealh gefera
Her on|an þes gear gefaran æþelm wiltunscir ealdorman nigon niht|neaht ær midde|midd sumere
& heran|her forþferan heahstan se wesan|seon|beon on|an lunden biscop

Mæg gehyran se þu|þe|ðe wyle be þæm|þam|se halig|halga|haleg mæden eugenia philippus dæhter hu heo þurh|ðurh mægþhad mærlice þiсgan|þicgan|þeon|þeah and þurh martyrdom þes middaneard oferswað
Sum æþelboren þægn wesan|seon|beon philippus hatan|gehatan se asendan se casere|caser commodus þu|þe|se on|an ðam|se dæg|dah|dag rixode fram romeburh toh|to se burh|burg þu|þe|ðe wesan|seon|is hatan|gehatan Alexandria
And he he gesette|gesettan toh|to heahgerefa ofer alexandria and egipte land|finna and hettan|het|hedan|hatan þæt|se he healdan þu|þa|se romanisc gesætnysse
Ðæs ðægn philippus næs|ne æs na gefullian on|an god forðam þu|þe|se cristendom næs|ne æs þu|þa|se git geond eall|eal cuð and seon|seo|se reþe|reðe eahtnes þu|þa|se git næs|ne æs gestylled
His wif wesan|seon|beon gecigan claudia be þære|se he gestrynan twægen|twegen sunu auitus and særgius and an dohtor eugenia þu|þe|se we ymb spræcaþ
Ða befæstan se fæder philippus toh|to lar þæt|se heo on|an weoroldwisdom wære|wær|wesan|seon|beon teon|geteon æfter grecisc uþwitigung and læden getingnysse
Eugenia þu|þa|se þæt|se æðele mæden|mecgan wel þiсgan|þicgan|þeon|þeah on|an wisdom and on|an uðwytegunge
Þa becuman hyrian|hyre|hyran|hyr|hire|heo on|an hand se halig|halga|haleg apostol lar paulus se mære|mæran eall|eal manncynn lareowes
Þa wearð hyrian|hyre|hyran|hyr|hire|heo mod micel onbryrdan þurh þu|þa|se halgen lar þiсgan|þicgan|þeon|þeah þu|þe|ðe heo þu|þa|se git hæðen wære
Heo bædan|biddan þu|þa|se hyrian|hyre|hyran|hyr|hire|heo fæder þæt|se heo færen motan geond hit|his|he ham on|an alexandisc scyre
Wolde swa cepan þære|se cristen lar forðam þu|þe|se heo næs|ne æfde on|an se burh|burg nan geleaffull|geleafful mann þu|þe|se hi|heo læran|lesan cuþ|cunnan forðam philippus afleon þu|þa|se cristen of alexandria ealle|eall|eal on|an ær
Hwæt þu|þa|se eugenia arodlice færde oþ|oð þæt|se heo becuman þær þe|þa|ða|se cristen singan mid micel bliss|blis þus mærsian God
Omnes dii gentium demonia dominus autem cælos fecit
Ealle þære|se hæðen gripe|god|ben syndon deofla
and dryhten soþlice|soðlice heofon geworhte
Eugenia þu|þa|se micel wearð onbryrdan and mid wop gesprecan hire|heo twægen|twegen cniht þære|se naman|nama wesan|seon|beon protus etan|et Iacinctus
Þa wesan|seon|beon gelæred on|an læden and on|an grecisc mid eugenia mid woruldliс|weoroldlic lar and wesan|seon|beon eunuchi þæt|se synt belisnian and wesan|seon|beon hira|hi|heore hlæfdige hold and getrywe
Ða niman eugenia hi|heo on|an sundorspræc hettan|het|hedan|hatan hi|heo gebroðor and bædan|biddan þæt|se hi|heo hyrian|hyre|hyran|hyr|hire|heo fæx forсeorfan|forceorfan on|an wæpenmann wise and mid wædum gehiwian swilce heo cniht wære
Wolde ðam|se cristen genealæcan on|an werlic hiw þæt|se heo nesan|neh|ne weorþan ameldod
Hi færdon þe|þa|ða|se þri and hira|hi|heore gefera forlætan oþ|oð þæt|se hi|heo becoman toh|to se cristen wunung þær hi|heo dæg and niht hira|hi|heore dryhten heroden
On ðam|se ilca dæge|dæg cuman sum|su bisceop helenus hatan|gehatan halig lifes|lif mid micel menigu anmodlice singende
Uia iustorum recta facta est etan|et iter sanctorum preparata est
þæt wesan|seon|is se rihtwis wegan wesan|seon|is gerihtlæced
and se halig|halga|haleg siþfæt wesan|seon|is gegearcod
Þes bisceop worhta fæle|fela wundrian|wundor|wund þurh God
and him|hi|he wearð geswutelian on|an swefen be þysum
and eall|eal se mæden mod him|hi|he wearð ameldod
Ða gesprecan þæt|se mæden|mecgan sum mæssepreost eutropius hatan|gehatan þæt|se he hyrian|hyre|hyran|hyr|hire|heo ærende|ærend abeodan þæm|þam|se bisceop þes word geornlice
we þri gebroðor wyllað gecyrran fram þæm|þam|se ful hæðenscipe toh|to hælend|hælan Criste
and we næs|ne ellað nateshwon we|us næfre totweman
Þa se on|an merigen se mæssepreost abeodan se mæden word þæm|þam|se mære bisceop þa|se hettan|het|hedan|hatan se bisceop hi|heo gelangian micel þancian þæm|þam|se ælmihtig|eallmihtig god þæt|se he willan him|hi|he onwreon se mæden wyllan
He geniman hi|heo þu|þa|se onsundrum and sæd|secgan hyrian|hyre|hyran|hyr|hire|heo gewislice hwæt#2 heo munan|mann|man nesan|neh|ne wesan|seon|beon and hwilc mægþ and þæt|se heo þurh mægþhad micel gelician þæm|þam|se heofonlic cyninge|cyning þu|þe|se heo сeosan|geсeosan|gecoren|geceosan|ceosan habban and cweðan þæt|se heo sculan swiþlice eahtnes for|faran mægþhad ðrowian and þiсgan|þicgan|þeon|þeah beon|beo|bannan gescildan þurh se soð dryhten þu|þe|se gescildan hit|his|he gecorenan
To hire|heo twegen cniht he cweðan þæt|se hi|heo heoldan æþelborenness on|an mod þiсgan|þicgan|þeon|þeah þu|þe|se hi|heo mann þeowian|þeowan and cweðan þæt|se hi|heo crist|Crist gesprecan þes godspellic wordum
Ne hatan|hat ic ge|eowan|eow na þeowan
ac ge synd min freond
Þa bebeodan se bisceop þæm|þam|se gebugan mæden þæt|se heo swa þurhwunade on|an þæm|þam|se werlic hiw oþ þæt|se hi|heo on|an fant gefyllan|gefullian wurdon|weorþan and mynsterlic drohtnung dearnunga geþeodde
Eugenia þu|þa|se wunian on|an þæm|þam|se mynster mid werlic mod þiсgan|þicgan|þeon|þeah þu|þe|se heo mæden|mecgan wære|wær|wesan|seon|beon mid hyrian|hyre|hyran|hyr|hire|heo twegen cniht uncuþ gehwa and healdan on|an hyrian|hyre|hyran|hyr|hire|heo þeaw halig drohtnung þurh|ðurh mod liðness and micel eadmodnes and þurh halig mægen þæm|þam|se hælend|hælan gecwæmde
Heo þiсgan|þicgan|þeon|þeah on|an lar se rihtan|riht geleafa and on|an godcundlic gewrytum mid god willa and wearð awendan of wulf toh|to sceape
Hyre geefemlæcan eacan|eac hyrian|hyre|hyran|hyr|hire|heo cniht protus etan|et iacinctus on|an synderliс|synderlic drohtnung and hyrian|hyre|hyran|hyr|hire|heo digolnes eall|eal bedyrndon
Philippus þe|þa|ða|se se fæder forwearð on|an mode
and seon|seo|se modor claudia mid murcnung wesan|seon|beon fornumen
and eall|eal seon|seo|se mægþ on|an mod wearð astyrian and sœ̄сan|seсan|secan þæt|se mæden|mecgan mid micel sarnysse
Hi axian æt|etan wicca and æt|etan wise|wis dry eacan|eac æt|etan hira|hi|heore leas god be þære|se godes|god þinene
Him wearð þu|þa|se gesecgan toh|to soþ þingan|þing þæt|se þe|þa|ða|se god hi|heo gegripan for|faran hyrian|hyre|hyran|hyr|hire|heo godnysse
Þa gelyfan|gelifan se fæder þære|se leasung and hettan|het|hedan|hatan asmiðian of smæte gold hyrian|hyre|hyran|hyr|hire|heo anlicnes and þu|þa|se wurðode swa swa halig gydenan
ac hit wesan|seon|beon gold swa þeah
Þa æfter þri gear se þu|þe|se heo gecyrran wesan|seon|beon gewitan se abbad þu|þe|se hyrian|hyre|hyran|hyr|hire|heo ealdor wæs
And þu|þa|se gebroðor sona ceosan onginnan eugenia toh|to abbad for|faran hyrian|hyre|hyran|hyr|hire|heo arfæst lif and næs|ne ystan þæt|se heo wesan|seon|beon wimman swa þeah
Ða wearð þæt|se mæden|mecgan micel hohfull hu heo æfre wer wissian sceolde
Ne durran swa þiсgan|þicgan|þeon|þeah hi|heo ealle|eall|eal gedrefan and hyra|hyr|hira|hi þeссean|þeссan|þeccan|geþeaht forseon acan|ac fæng toh|to ðam|se hade
Hwæt þe|þa|ða|se eugenia he eall|eal gebysnian mid god gedrohtnung toh|to godes|god þeowdom and mid carfulnys þonne|se hyred|hyran|gehyran gewissode
Hyre geuðe þu|þa|se se ælmihtig|eallmihtig wealdend þæt|se heo untrum mann miht|meaht|magan gehælan swa hwilc swa heo geneosian licgan on|an sare
Heo afleon eacan|eac swilce þu|þa|se ful deofol fram ofsettan mann þurh soð geleafan
Þa wesan|seon|beon sum|su wif welig on|an æht melantia gecigan swiðe|swiðan þearle gedreccan|dreссan mid langsumum|langsum fefer and cuman toh|to se femnan
Eugenia þu|þa|se hi|heo gesmyrian mid gehalgian elh|ele and eacan|eac gemearcod|gemearcian mid rodetacne
And heo þæt|se reðe ator eall|eal ut aspiwan þu|þe|se hyrian|hyre|hyran|hyr|hire|heo dærede and weorþan hælan|gehælan þurh þæt|se halig mæden
Þa beodan seon|seo|se widuwe þæm|þam|se mæden sceatt for|faran hyrian|hyre|hyran|hyr|hire|heo hæle
ac heo hi|heo forsacan and tyhtan þe|þa|ða|se oþer|oðer þæt|se heo hi|heo dælan þearfa and wædla for|faran ðam|se gewiss|gewis eadleane
Ða gewænde seon|seo|se widuwe ham toh|to hyrian|hyre|hyran|hyr|hire|heo agen and cuman siððan gelome|gelom mid leas mod toh|to þæm|þam|se wlitig mædene
wende þæt|se heo cniht wære|wær|wesan|seon|beon and manigfeald sceatt hyrian|hyre|hyran|hyr|hire|heo unmæþlice bead
Ac þu|þa|se þu|þa|se heo geseon þæt|se seon|seo|se soþfæst fæmne hyrian|hyre|hyran|hyr|hire|heo lacu|lac nesan|neh|ne reссan|reccan|recan nesan|neh|ne hyrian|hyre|hyran|hyr|hire|heo runung þu|þa|se wearð heo mid yfele|yfel eall|eal afyllan and gebredan hi|heo seoc mid bysmorfull geþance
Heo bædan|biddan þu|þa|se eugenia þæt|se heo hi|heo geneosian and onginnan hyrian|hyre|hyran|hyr|hire|heo sæcgan hyrian|hyre|hyran|hyr|hire|heo sweart geþohtas
Cwæð þæt|se heo wære|wær|wesan|seon|beon widuwe on|an þæm|þam|se geare
and hyrian|hyre|hyran|hyr|hire|heo wer læfan unlytel æht on|an land|finna and on|an feoh and on|an forewyrcendum
And wit næs|ne æs gemæne munan|mann|man on|an þes lyfe
Nu wesan|seon|is min|ic mod awendan micel toh|to þu|þe|ðe þæt|se þu hlaford beon|beo se æht and min
Ic wennan|wenan|wen þæt|se hit nesan|neh|ne su unrihtwisness ætforan god þiсgan|þicgan|þeon|þeah þu|þe|ðe þu wif brucan and blis on|an life
Ða andwyrde|andwyrdan|andwerdan eugenia þes oleccung and cweðan toh|to þæm|þam|se wif mid þes ingehyde þæt|se þe|þa|ða|se gewilnung þes andweard weorold synt swiðe|swiðan swicol þiсgan|þicgan|þeon|þeah þu|þe|se hi|heo geswæs beon|beo|bannan and se lichoman lust gelome|gelom bepæcan and toh|to sarness gelædan þu|þa|se þu|þe|se hi|heo swiðe lufiað
Æfter þes tyhting and on|an oðer lar beclyppan|beclypian seon|seo|se miltestre þæt|se clæne mæden|mecgan and willan hi|heo gebygan toh|to bismerlic hæmede
Hwæt þe|þa|ða|se eugenia hi|heo gebledsian and cweðan toh|to se sceand þæt|se heo soþlice|soðlice wære|wær|wesan|seon|beon galnes ontendness and grama|gram mæge|mæg|magan þeostru|þeostrian gefara and mid sweartnysse afyllan deaðes dohtor and deofol fætels
Habban þin æht þin gelican
We habbað ealle|eall|eal ðing mid þæm|þam|se ælmihtig|eallmihtig Drihtne
Ða wearð melantia micel ofsceamod
wende þæt|se heo willan hyrian|hyre|hyran|hyr|hire|heo word ameldian butan heo self on|an ær hit openlice cydde
Færde þu|þa|se arodlice toh|to alexandria burh|burg toh|to þæm|þam|se heahgerefa þu|þe|se wesan|seon|beon hatan|gehatan philippus eugenia fæder þiсgan|þicgan|þeon|þeah seon|seo|se ful|feolan þæt|se næs|ne ystan|yst and beginnan hi|heo toh|to wregan and willan forsæcgan
Cwæð þæt|se heo gan|eadan toh|to hyrian|hyre|hyran|hyr|hire|heo licgendre on|an læce hiw and hi|heo willan forlicgan gif heo þæt|se bismer forberan wolde
Ac ic hryman sona mid sarlic stefn oþ þæt|se on|an min wimmanna me|ic wiþ|wið he ahredde
Ða gelyfan|gelifan philippus þære|se facenful segen and swiðe|swiðan gehathirtan hettan|het|hedan|hatan hi|heo gefeccan and eacan|eac þe|þa|ða|se gebroðor ealle|eall|eal gebindan and healdan hi|heo on|an bend and on|an blind cweartern oþ|oð þæt|se he mid wytum þæt|se wif gewræce
Þa cuman se dæg þu|þe|se se dema gesætte
And wesan|seon|beon gegearcian þu|þa|se reðe wyta
And wurdon|weorþan gefetian ætforan þæm|þam|se deman|dema þu|þa|se unscyldig cristen on|an swærtum racentægum
Ða cweðan philippus mid full|ful grama|gram toh|to eugenia hit|his|he agen dehter
Sege þu forscyldeguda
hwi willan þu beswican þæt|se mære|mæran wif melantia mid forliger and on|an læce hiw hi|heo forlicgan woldest
Ða cweðan eugenia þæt|se heo eaþe|eaþ miht|meaht|magan se forliger unhlisa hi|heo beladian and melantia onsagu mid soð oferdrifan gif philippus willan gefæstnian mid aþ þæt|se seon|seo|se leas wregestre nesan|neh|ne weorþan fordæmed
Ða swerian philippus þæt|se he friþian willan þu|þa|se leas widuwe þeah þu|þe|se heo gelygnian wurðe
Þa bædan|biddan eugenia þæt|se seon|seo|se wiln sculan sæcgan þæm|þam|se deman|dema hu hit gedon|gedo|don wære|wær|wesan|seon|beon and hu heo hyrian|hyre|hyran|hyr|hire|heo hlæfdige wiþ|wið hyrian|hyre|hyran|hyr|hire|heo lust ahrædde
And se gerefa hettan|het|hedan|hatan eacan|eac þu|þa|se cniht melantia hyredes cyþan be þes gif hi|heo þes gehyrdon
Þa cweðan seon|seo|se wiln þæt|se heo wyste gefyrn hu eugenia feran fracodlice on|an forliger and willan þu|þa|se æt-nyhstan hyrian|hyre|hyran|hyr|hire|heo hlæfdige gebismerian butan heo mid hream hyrian|hyre|hyran|hyr|hire|heo hredding ofclypode
þis witan|wita þes hiredmann þu|þe|se ic þider clypode
Ða secgan þu|þa|se hiredmann þæt|se hit soð wære
and ealle|eall|eal mid aþ eugenia forlugan
Þa wearð se geræfa þearle gebelgan|belgan and axude eugenia hu heo ana|an miht|meaht|magan ealle|eall|eal þu|þa|se gewita awægan mid aþ oððe þurh ænig sweotolung hi|heo self aclænsian
Hwæt þe|þa|ða|se eugenia seon|seo|se æþelu|æþele|æþel|æðele fæmne cweðan þæt|se heo willan hi|heo self bediglian and crist|Crist an hyrian|hyre|hyran|hyr|hire|heo clænnes healdan|heald on|an mægþhad wunian mann uncuþ and forði underfon æt|etan fruma þu|þa|se gerela werlic had and weorþan geefsod
Æfter þes word heo toteran hyrian|hyre|hyran|hyr|hire|heo gewæde and æteowian hyrian|hyre|hyran|hyr|hire|heo breost þæm|þam|se breme philippus and cweðan him|hi|he to
þu wesan|seon min|ic fæder
and þu|þin gebædda claudia geberan me|ic toh|to mannum
and þes|se þin gesetla synd min gebroðor auitus and Særgius
and ic soþlice|soðlice wesan|seon|eoh eugenia hatan|gehatan þu|þin ongeagn|agen|agan dohtor
And ic for|faran crist|Crist lufu|lufe forlætan|forlædan ge|eowan|eow ealle|eall|eal and middaneardlic lust swa swa meox forseah
Her synd eacan|eac þu|þa|se cniht þu|þe|se ic cyþan min digolnes protus etan|et iacinctus þin fostercild mid ðam|se ic becuman toh|to crist|Crist scolu|scol and þæron drohtnian oþ|oð þes andwærden dæg
and ðam|se ic wylle æfre oþ|oð ende þeowian
Ða oncnawan philippus swa swa fæder Eugenian
and auitus and sergius hyra|hyr|hira|hi agen swyster
and hyra|hyr|hira|hi hiredcniht hi|heo eadmodlice cyston
Þis wearð sona gecyd claudia þære|se mæder
and heo mid wundrung wearð befon and toh|to eugenia cuman mid eall|eal blysse
Hi þu|þa|se gefrætewian þu|þa|se fæmne mid gold hyrian|hyre|hyran|hyr|hire|heo unþanc and up gesettan toh|to him
Þa clypian þæt|se folc þæt|se crist|Crist wære|wær|wesan|seon|beon soð God
and hi|heo ealle|eall|eal herodon þonne|se hælend mid wuldre
Eugenia habban ær þingian|geþingian þære|se leas melantia toh|to hyrian|hyre|hyran|hyr|hire|heo leof fæder þæt|se heo mid wytum nesan|neh|ne awrecan hyrian|hyre|hyran|hyr|hire|heo wælhreow ehtnysse
Ac crist|Crist self asendan swegan fyr ufan of heofon þæt|se mann onhawian toh|to melantia botl and hit mid ealle|eall|eal forbærnan swa þæt|se þær næs|ne æs toh|to laf nan ðing þu|þe|se hyrian|hyre|hyran|hyr|hire|heo wæs
Þa wurdon|weorþan gefyllan|gefullian philippus and claudia and hira|hi|heore twægen|twegen sunu mid soð geleafan
and seon|seo|se micel menigu se mennisc gebugan toh|to crist|Crist bigenga|bigeng and þu|þa|se cristen gegododon
Ða wurdon|weorþan geedniwian on|an ðam|se eahtoþa geare|gear þu|þa|se forlætenan cyrcan
and seon|seo|se geleaffulnes weox
Philippus þu|þa|se asendan toh|to seuerus þæm|þam|se casere|caser and sæd|secgan þæt|se þu|þa|se cristen swiðe|swiðan fremian hit|his|he cynerice and romanisc leode|leodan|leod and hi|heo wæl|wel weorþ wesan|seon|beon þæt|se hi|heo wunian butan eahtnes on|an se ilca burh|burg þu|þe|se he hi|heo ær of adræfde
Þa geþafian se casere|caser þæt|se ðam|se geræfan
and alexandria seon|seo|se burh sona wearð afyllan mid micel cristendom and manig cyrcum
And on|an gehwylc burh|burg blissian þu|þa|se cristen and mid weorþfulness god wurðodon eacan|eac for|faran þes intinga þæt|se egiptisc folc forlætenum gedwyld gelyfan|gelifan on|an Drihten
And philippus forgifan|forgiefan fæle|fela eahtian|eahta þæm|þam|se cristen him|hi|he toh|to gemæne bryce and hi|heo gemundode
Æfter þes gelimpan þæt|se þe|þa|ða|se leas hæðena|hæðen wregan philippus toh|to ðam|se foresecgan casere
sædon þæt|se he forlætan þu|þa|se lifian gripe|god|ben and ealle|eall|eal þu|þa|se burhware gebugan toh|to Criste
Þa wearð se casere|caser sona geyrsian and bebeodan philippus þæt|se he bugan toh|to hit|his|he god oððe wære|wær|wesan|seon|beon benæman wurðscipes and æhta
Þa dælan philippus digollice hit|his|he æht geond ealle|eall|eal þu|þa|se scir circe and þearfa and þurh micel geleafa manig|manega oðer getrymman swa þæt|se þe|þa|ða|se cristen he geсeosan|geceosan toh|to bisceope
Ða æfter twelf monað gemunan se casere|caser hwæt#2 him|hi|he gesecgan wesan|seon|beon and sænde fram rom oðer gerefa mid reðe bebod swa þæt|se he hettan|het|hedan|hatan acwellan se cristen philippus gif hit soð wære|wær|wesan|seon|beon swa him|hi|he gesecgan wæs
Ða cuman se gerefa and he acwellan nesan|neh|ne durran on|an se folc gewitnes for|faran hira|hi|heore freondræden acan|ac asendan sum þu|þe|se secgan þæt|se hi|heo wær on|an crist|Crist gelyfede
ac hi|heo leogan swa þeah
Ða gan|eadan toh|to circe mid swiþlic facn|facen and se mære|mæran bisceop on|an hit|his|he gebed ofslogan
Ac he wunade swa þeah on|an þæm|þam|se wund cucu geond þri dæg|dah|dagian|dag fæc and gefrefrian þu|þa|se cristen and swa mid martyrdom siððan gewitan toh|to ðam|se lifian dryhten þu|þe|se he on|an lif wurðode
Eugenia habban ær þan|se astellan mynecenu mynster mid micel gehealdsumnysse
and seon|seo|se modor claudia hit micel gegodode
and hi|heo þær bebyrgan se bisceop Philippum
And hi|heo siððan ealle|eall|eal endemes færdon seon|seo|se modor and seon|seo|se dohtor toh|to se mære|mæran romeburh and þe|þa|ða|se gebroðor samod sergius and Auitus
And þu|þa|se romanisc wytan hi|heo wel underfon and for|faran þære|se eald cyþ se æðele Philippes
Þa gesettan þu|þa|se wytan sona þu|þa|se cniht on|an twegen heafodburh on|an healic weorþmynd an on|an affrica and oðer on|an Cartagine
Eugenia þu|þa|se wunian on|an Rome
and hire|heo coman toh|to gehwylc mædenu
and heo hi|heo gebegan mid hyrian|hyre|hyran|hyr|hire|heo gebysnung toh|to Criste
and hi|heo on|an mægþhad wunian þurh hyrian|hyre|hyran|hyr|hire|heo mynegunge
Þa wesan|seon|beon on|an romeburh sum|su cyneboren mæden|mecgan basilla hatan|gehatan on|an hæðenscipe wunian seon|seo|se willan gehyran þu|þa|se halig|halga|haleg lar of eugenia muþe
ac heo nesan|neh|ne miht|meaht|magan hire|heo genealæcan forðam þu|þe|se cristendom wesan|seon|beon þær onscunigendlic
Ða sendan eugenia þu|þa|se twægen|twegen halig|halga|haleg protus and iacinctus toh|to ðam|se hæðen mædene
Hwæt þu|þa|se basilla mid blis hi|heo underfon and deges and niht mid þæm|þam|se deorwyrþe halig|halga|haleg godes|god lar began and hyrian|hyre|hyran|hyr|hire|heo gebed nesan|neh|ne geswican oþ|oð þæt|ðæt|se cornelius se cristen bisceop hi|heo dearnunga gefyllan|gefullian fram eall|eal fulnyssum
Þa wurdon|weorþan gelome|gelom þu|þa|se leof mæden eugenia and basilla and eacan|eac se bisceop on|an sundorspræc swiðe|swiðan gebysgode
and digellice on|an niht|neaht hi|heo simble geneosian and habban hira|hi|heore gerihte|geriht mid þæm|þam|se halgen biscope
Þurh þes|se twegen|twa mæden manig|manega oðer becoman toh|to crist|Crist geleafa and toh|to clæne drohtnunge
Ðurh claudia becoman eacan|eac clæne widuwe mid god willa toh|to godes|god geleafan
And fæle|fela cniht on|an crist|Crist gelyfan þurh þe|þa|ða|se twægen|twegen halig|halga|haleg protus etan|et Iacinctum
Basilla habban an hæðen wogere pompeius gecigan swiðe|swiðan æðelboren þæm|þam|se geuðe se casere|caser þæt|se cyneboren mæden
ac heo habban сeosan|geсeosan|gecoren|geceosan|ceosan crist|Crist hyrian|hyre|hyran|hyr|hire|heo toh|to brydguma and se hæðena|hæðen wogere forði habban næs|ne olde
Þa geseсan|gesecan se cniht se casere fett
and þu|þa|se romanisc wytan mid woplic ceorung him|hi|he mid sprecan and þe|þa|ða|se mæden wregan eugenia and basilla biddan hit|his|he fultumes
Hwæt þu|þa|se se casere|caser cweðan him|hi|he toh|to andswaru þæt|se basilla sculan gebugan toh|to ðam|se cnihte
oþþe hi|heo munan|mann|man toheawan mid heard sweord on|an twa
And eugenia he hettan|het|hedan|hatan hit|his|he god geoffrian
oððe hi|heo munan|mann|man mid wytum wælhreowlice acwealde
He hettan|het|hedan|hatan eacan|eac acwellan ealle|eall|eal þu|þa|se cristen gif hi|heo næs|ne oldon bugan toh|to ðam|se bysmorfull hæðenscype
Þa næs|ne olde basilla brydguma geceosan nan butan crist|Crist þu|þe|se heo сeosan|geсeosan|gecoren|geceosan|ceosan habban and wearð þu|þa|se martyrian|gemartyrod|gemartyrian for|faran hyrian|hyre|hyran|hyr|hire|heo mægþhad æt|etan ham on|an hire|heo hus mid heard sweorde
Æfter þes word þu|þa|se twægen|twegen godes|god halig|halga|haleg protus and iacinctus wurdon|weorþan sona gelæhte
and hi|heo sculan geoffrian hira|hi|heore lacan|lac þæm|þam|se godum
oððe hi|heo self sculan him|hi|he beon|beo|bannan geoffrode
Hi wurdon|weorþan þu|þa|se gelædan toh|to þære|se lað anlicnysse
ac heo tofeallan sona toh|to hira|hi|heore fot formolsnian swa raðe swa þu|þa|se halig|halga|haleg hi|heo toh|to god gebædon
Þa cweþan se dema þæt|se hi|heo mid drycræft þu|þa|se anlicnes toweorpan and wearð gebolgen
Het þu|þa|se beheafdian þe|þa|ða|se halig|halga|haleg cyðeras
and hi|heo swa feran mid sige|sigan|seon toh|to Criste
Ðas martyr næs|ne æron næfre on|an lif þurh wif besmytene
ac hi|heo wunedon on|an clænnes oþ|oð hira|hi|heore lifes|lif ænde mid micel geleafan
Æfter þes wearð leссan|gelæccan seon|seo|se geleaffull eugenia and toh|to þæm|þam|se hæðena|hæðen templ|tempel teon|geteon mid geþreat þæt|se heo þære|se gyden diana godes|god weorþmynd gebude
Ða gebiddan eugenia hi|heo toh|to ðam|se ælmihtig|eallmihtig Gode
and þæt|se deofol templ|tempel grundlinga tofeallan and on|an eorþ|eorðe besincan mid eall|eal hit|his|he anlicnyssum
Þa hettan|het|hedan|hatan se casere|caser ahon an weorcstan on|an hyrian|hyre|hyran|hyr|hire|heo halig|halga|haleg swuran and hi|heo bescufan on|an þe|þa|ða|se ea
Eac se stan tobærst
and heo sæt|sittan up on|an þæm|þam|se wæter þæt|se þe|þa|ða|se cristen tocnawan þæt|se crist|Crist wesan|seon|beon mid hyrian|hyre|hyran|hyr|hire|heo se þu|þe|ðe hwilum ær se halig|halga|haleg petrus be se hand gelædan upp on|an þæm|þam|se heah brymme þæt|se þe|þa|ða|se sælic yða he forswelgan nesan|neh|ne mihton
Ða hettan|het|hedan|hatan se casere|caser hi|heo siððan bescufan on|an beornan ofen þær þær hatan|hat baðu wæron
ac þæt|se fyr wearð acwencan and þu|þa|se baðu acolian and ealle|eall|eal þe|þa|ða|se ontendness mid hyrian|hyre|hyran|hyr|hire|heo tocyme adwæscte
Heo wearð þu|þa|se gebrengan|bringan|brengan into blind cwearterne
and geond twentig dæg|dah|dagian|dag hyrian|hyre|hyran|hyr|hire|heo næs|ne æs getiðian ænig bigleofa binnan ðam|se þeostrum
Ac se hælend cuman mid heofonlic sunnan|leoht and bringan|brengan ðam|se mæden mære bigleofa snawhwit hlaf and onlihtan þæt|ðæt|se cweartern
Þa cweðan se hælend toh|to ðam|se halig|halga|haleg mædene
Eala þu eugenia nesan|neh|ne beon|beo þu afyrht
Ic wesan|seon|eoh þu|þin hælend þu|þe|se þu healice wurðost and mid eall|eal mod and mægen lufast
On þæm|þam|se dæge|dæg þu|þa|se sculan cuman|cuma toh|to me|ic þu|þe|se ic cuman toh|to mannum
and on|an minre|min gebyrdtid þu beon on|an heofon gebroht
Þa cuman se cwellere on|an crist|Crist acennednes dæge|dæg asendan fram þæm|þam|se casere
and he þæt|se mæden|mecgan acwealde
Heo wearð þu|þa|se gemartyrod
and cristen mann hi|heo bebyrgdon
Ða wepan seon|seo|se modor mid micel sarness æt|etan hyrian|hyre|hyran|hyr|hire|heo byrgen oþ þæt|se heo hi|heo geseon on|an gastliс|gastlic gesiht mid gold gefrætewian mid ðam|se heofonlic werod|weorod þus hi|heo frefrigende
Min modor claudia me|ic hæfð gebrengan|bringan|brengan min|ic hælend crist|Crist toh|to hit|his|he halig|halga|haleg blis and min fæder gelogian on|an þære|se heahfæder getele
and þu cuman toh|to we|us nu on|an Sunnandæg
Seo modor gewitan þe|þa|ða|se of weorold toh|to heofon on|an ðam|se Sunnandæge
and þu|þa|se sunu hi|heo bestandan sergius and Auitus
and hi|heo siððan þurhwunian on|an ðam|se soð geleafa oþ|oð hira|hi|heore lifes|lif ende
Sy wuldor|seolh|bearm and lof þæm|þam|se welwillende dryhten on|an eall|eal weorold weorold eall|eal hit|his|he weldæda
AMEN
Basilius wesan hatan|gehatan sum|su halig bisceop se wesan|seon|beon fram cildhad swiðe|swiðan gehealdsum þiсgan|þicgan|þeon|þeah þu|þe|se he toh|to lang fyrst|first ungefullod wære
