abal	afol|es
æfer	
ælf	es
æs	es
æsp	an|e|æspe
æx	=
asce	acse|ahse|an|axe|axse|æsce [ æscean]|æxe
ate	átan|átena|ǽte
aþum	es
awa	áwo
bæl	es
bælc	es
banc	e
bannan	bannaþ|bannen|banst|banþ|benst|benþ|beón|beónn|beónnon|bonnan|bén|bénn|he banneþ|ic banne|ðú bannest
beado	beadowe|beadu|beaduwe|beadwe
bean	bién|e
bearo	-wa|-wum|bearo|bearowe|bearu|bearuwe|bearwas|bearwe|bearwes
befer	beofer|beofor|byfor|es
belg	belig|bilig|bylg|bylig|bælg|bælig|es
bell	an :|belle|e
beo	beóm|beón|beóna|beóum
beor	es
beost	býst|býsting|es
beot	es
bere	es
berie	an|berge|berige|berigie
bete	an|béte
bicce	an|bice|bicge
bin	binn|e
birce	beorc|berc|byrc|e|ean
blætan	[blǽt ]|blǽtte|blǽtted
blat	blátast|blátra
blegen	e
bleoh	bleó|bleós|blioh|blió
blot	es
bolca	an
bor	
borh	a|borgas|borge|borges|borh|um
bosg	bósig|bósih|es|or
bosum	bósm|es
bræs	es
brastl	es
bread	breód|es
bremel	brémbel|brémber|brǽmbel|es
brer	es
brerd	breard|breord|briord|es
bridel	bridles
burn	[ burnon|an|beornan  fervere]|burna|burne|e
byl	bíle|býle|es
byld	byldo|e
byme	an|béme|salpinx =|tuba
byrgan	birgan|birgean|birigan|byrian|byrigan|byrigean|de|ed [beorg ]
byrgan	beorgan|býrgean|býrian|býrigan|býrigean|de|ed
byrle	byrele|es
byrne	an
bysgu	a|bísegu|bísgu|bísigu|býsegu|býsigu|o:  u|u|um
cæg	an|cǽga|cǽge|cǽgia
cæppe	an
cærse	CRESS|an|cardămum =|cerse|nasturtium
caf	est|ost|ra|re
camp	comp|es
candel	CANDLE|candel|candela|candell|condel|condell|e|es|lampas =
canne	an
canon	CANON|canon =|es|regula
capun	CAPON|cape =|es|gallinaceus
carr	es|m.
cat	catt|es
ceaf	ceafu|cef|es
ceafer	CHAFER|brūchus =|ceafor|es
ceas	e|es
cen	es
ceo	ció
ceole	an|ciole
ceosel	ceosol|cisil|cysel|es|m?
ceren	cyrin|e
cerfille	CHERVIL|Lin|an|chærophyllum sylvestre|cyrfille|cærefolium =|cærfille
cider	es
cifan	cifen|cifon|cáf
cin	cyn|e
cine	an|cýne
cirm	cyrm|es
cla	clawa|clawe|clawena|clawu|clawum|cleó|clám
clæfre	an
clæman	de|ed
clate	CLOT- philanthropos =|Lin|an|arctium lappa|galium aparine|lappa
claþ	cláðes
clibbor	[clifian ]
clif	cleof|clyf|es
clifan	clifaþ|clifen|clifon|cláf|clífst|clífþ|he clífeþ|ic clífe|ðú clífest
cloccian	od|ode
clom	clam|clammes|clommes
clud	es
clugge	an
clustor	clauster|clustro|clúster|clústor|clústres
clympre	an
clyster	CLUSTER|botrus|clystra|clystres|clystru|clystrum|f. racemus|propago
clywe	an
cnæp	cnep|cnæpp|es
cnear	cnearr|es
cnedan	cnedaþ|cneden|cnist|cnǽdon|he cnit|he cnæd|ic|ic cnede|ðú cnidest|ðú cnǽde
cnoll	es
cnosl	es
cnucel	cnucles
cnucian	cnucigan|od|ode
cnyttan	cnittan|cnyt|cnytt|cnytte|cnytted
coccel	es
cocer	cocor|cocur|es
colt	es
cops	cosp|es
cos	coss|es
costian	ad|ade|costigan|costnian|ed|ede|od|ode
cot	COT|casa|cota|cott|cottum|cotu|cotum|cubiculum|cubile|domus|es|spelunca
crabba	an
cradel	cradol|es
cræt	crat|cratu|cratum|cræta|crætu|crætum|es
crafian	crafigan|ed|ede|od|ode
creodan	creódaþ|croden|crudon|crýdeþ|crýst|crýt|crýtst|he creád|he creódeþ|ic|ic creóde|ðu crude|ðú creódest
crop	cropp|es
crumb	crump
cryb	crybbe
culter	cultres|cultur
cumb	es
cumbol	cumbl|cuml|es
cuppe	an
curs	es
cusc	
cwalu	e
cwanian	cwániende|ed|ede|od|ode
cwiþ	an|cwiða|es
cwudu	cudu|cweodo|cwidu|cwuda|ues|wes
cwyrn	an|cweorn|cweorne|e
cwysan	de|ed
cyf	an|cýfe|e
cyfes	an|ciefes|cifes|cyfese|cyfys|e
cylen	cyln|e
cyll	an|ascopēra =|cille|cylle|e|es|uter
cynd	es
cyp	cyppes
cyrfæt	cyrfet|es
cyrice	an|circ|circe|ciric|cirice|cyrce|cyric|cyric-ǽwe|e|ean|etc. q. v.
cyse	an|cysa|cése|es
cyta	an
cytel	cetel|citel|es|lĕbes =|or  cācăbus =
dah	dáges|dóh
daru	daro|e
deaw	es
denn	es
diht	es
dile	dyle|es
dilegian	dielgian|dilgian|od|ode
dim	se dimma|seó|ðæt dimme
docce	an
dogor	dóger|es
dolh	dolg|es
drædan	dreórd|dréd|drédon|drǽdaþ|drǽden|drǽst|drǽt|drǽtest|he drǽdeþ|ic drǽde|ðú drǽdest
dran	drǽn|e
dreng	es
dreor	es
drof	
dropa	an
drosna	drosna|drosne|drosnum
dubban	ad|ade
dwellan	dweald|dwealde|dweled.|dwelede|dwellaþ|dwelst|dwelþ|he dweleþ|ic dwelle|ðú dwelest
dynt	es
dyttan	de|ed
earfe	an|earbe|ervurn|orŏbus=
earfeþe	a|earfoþ|es|o|u
ears	es|ærs
eax	e|ex|æx
eaxel	an|e|eaxl|eaxle|exl
ebba	an
ecg	e
egl	e
ellen	elnes
ellen	es
elm	ellm|es
eolh	15|Ettmül. Poet. 288|[eolx  eolc|cole|eolces|eolcs|eolh|eolhes|eolx|note]
eornost	e|eornest|eornust
esne	es
esol	es|esul
fæhþ	an|e|fǽgþ|fǽhþe|fǽhþo|fǽhþu
færbu	e
fæsl	es
fæþm	e|es|fæðm
fag	fáh|se fága|seó|ðæt fáge
fah	fá|fág|fára|fáum
fals	es
fana	an
fann	e
faru	e
fealo	feale|fealu|se fealwa
felg	an|e|felge
felt	es
fen	es|fenn|fæn|fænn
feogan	feódan|feóde|feódon|feódun|feógaþ|feógean|feógeaþ|feógende|feón|feóþ|fiógan|fión|he feógeþ|ic feóge
feohan	feah|fegen|feón|feónde|fǽgon
feol	e
feorh	feora|feore|feores|feorg|feorh|feorum|ferh|fiorh|fyorh
fetel	feteles|fetles
feter	e|fetor
fin	es|finn
finc	es
finol	an|es|fenol|finel|finugle|finul|finule|fynel
firen	e|firena|firene|fyren
fiþele	an
fla	[flae|]|flaa|flaan = flán|flán|flána|flánum
flaxe	an
flea	an
fleot	an|es|fleóte|fliét
flint	es
flit	es
floc	es
flor	es|flór|flóra|flóre
flys	fiís|fleŏs. es|fliés|flés
foda	an
font	es
forca	an
forn	e
forst	es
foster	fóstor|fóstres|fóstur
foþer	es|fóður
frasian	ad|ade|freásian
frecne	frǽcne
fremede	fremde|fremþe|fræmde
fremu	e
freo	freoh|frig|frioh|frió|frí|frý
frogga	an|frocga|froga
frum	se fruma
fugel	fugeles|fugles|fugol|fugul
furh	furum|fyrh
furþor	furður
fyll	e|fill|fyllo|fyllu
fyll	es|fell|fiell|fyl
fylst	e
fylþ	e
fyrhto	e|fyrhtu
fyrn	
fyrs	es
fyrwet	-wit|-wyt|es
gad	e
gad	es|gǽd
gaf	
galga	an|gealga
gandra	an|ganra
gang	es|geng|gong|gung
ganian	od|ode
gar	es
gea	
gealla	an|ealla
gearn	es|gern
geatas	Eótenas [v.|II.]|Iótas|Iútas|a|um
geles	-lis|es
gelm	es|gilm
geloman	
gen	gién
geo	gió
gerd	e
gerst	GRIST
gese	gise|gyse [ge+se = geá+sí]
gest	es
gilp	es|gelp|gielp|gylp
gim	gimm|gimmes|gym|gymm
gin	es
gist	es|gyst
gitan	geat|geáton|gietaþ|giete|gitaþ gytaþ|giten|gyte|he git|ic gite|ðú gitst
glæs	es
gleam	es
gled	e
gnæt	gnætt|gnættes
gnidan	gniden|gnidon|gnád|gnídaþ|he gnít|ic gníde|ðú gníst
greada	an
greot	es
gynan	
gyr	
gyt	
healm	es
hearm	es|herm
hedan	de
hege	es
hela	an|hǽla
help	e|es
heorþ	es
hete	es
hoc	es
holt	es
hord	es
hreaw	hrǽw [ hreów]
hreddan	de
hreoh	
husel	es|húsl|húsul
hyf	e
hyþ	'|e
ifig	es|ifegn
leoþ	es
lystan	te
mæd	(?) mǽdwa|an|e  we|mǽdwe
milde	
milte	an|es
